CDN Content delivery network
guide	n.领路人,导游者,向导,引导者,指南vt.指导,支配,管理,带领,操纵vi.任向导
documentation	n.证明某事属实的证据.记录.参考资料.文献的编集，文件分类.;
stack	n.垛，干草堆.（一排）烟囱.层积.整个的藏书架排列.;vt.& vi.堆成堆，垛.堆起来或覆盖住.洗牌作弊.秘密事先运作.;
overflow	vt.& vi.溢出，淹没.挤满，充满.洋溢.资源过剩.;n.泛滥，溢出物.溢流管.充溢，过多.超出额.;vi.泛滥，溢出.充溢.;adj.溢出的，满出的.;
commercial	adj.商业的.贸易的.营利的.靠广告收入的.;n.（电台或电视播放的）广告.;
foundation	n.基础,根本,建立,创立,地基,基金,基金会
challenge	n.挑战vt.向...挑战
depend	vi.依靠.依赖.信赖.决定于.;
experience	n.经验，体验.经历，阅历.;vt.亲身参与，亲身经历.感受.发现.;
programming	n.规划，设计.编程.;v.训练( programme的现在分词 ).培养.预调.;
concept	n.观念，概念.观点.思想，设想，想法.总的印象.;
project	vt.放映.计划.发射.展现，使突出.;vi.伸出，突出.;n.项目，工程.计划，规划.（学生的）课题.;
library	n.图书馆，藏书楼.藏书.书屋，书斋.图书出租处.;
essential	adj.基本的.必要的.本质的.精华的.;n.必需品.基本要素.必不可少的东西.;
structure	n.结构.构造.建筑物.体系.;vt.构成，排列.安排.;
debugging	n.调试.;v.拆除窃听器( debug的现在分词 ).排除故障.;
construct	vt.修建，建造.构成.创立.[数]作图.;n.结构（物）.构想.概念.;
syntax	n.[语]语法,有秩序的排列,句子构造,句法
tutorial	n.个别辅导时间.教程，辅导材料.使用说明书.辅导课.;adj.导师的.私人教师的.辅导的.;
developer	n.开发者.<摄>显影剂，显像剂.;
additional	adj.额外的，附加的.另外的，追加的.补充.外加.;
suggestion	n.建议，意见，暗示.联想，启发.微量.;
issue	n.出版,发行,(报刊等)期、号,论点,问题,结果,(水,血等的)流出vi.发行,流出,造成...结果,进行辩护,传下vt.使流出,放出,发行(钞票等),发布(命令),出版(书等)发给 [律]子女,后嗣
effects	n.动产，财物，家财.结果( effect的名词复数 ).效果.感受.个人财产.;
performance	n.履行,执行,成绩,性能,表演,演奏
organization	n.组织.机构.团体.;adj.有组织的.;
edition	n.版次，版本.（报纸、杂志的）一份.（广播、电视节目的）一期.（书、报、杂志等的）一版印刷总数.;
api	abbr.acceptable periodic inspection 合意周期检查.armor-piercing incendiary tracer 追踪式穿甲燃烧弹.;
twitter	vi.（人因兴奋）嘁嘁喳喳地讲.（鸟）叽叽喳喳地叫.格格地笑.（激动得）抖颤.;vt.（鸟等）吱吱叫.唧唧喳喳地讲述.颤动.抖动.;n.（鸟）叽叽喳喳的叫声.格格的笑声.一个网站名称.;vt.& vi.在Twitter网站上写信息.;
digital	adj.数字的.数据的.手指的.指状的.;n.手指.（钢琴等的）琴键.数字.;
ocean	n.洋.海洋.大海.（地球上划分出的）洋.;
sizzle	vi.咝咝的响vt.烧灼n.咝咝声
contribute	vt.& vi.贡献出.捐赠（款项）.投稿（给杂志等）.出力.;
cla	abbr.communication link analyzer 通讯连接分析器.;
support	vt.支撑,扶持,支持,支援,拥护,维持,赡养,忍受n.支撑,支持,支援,维持,赡养,支持者,支柱
forum	n.论坛，讨论会，专题讨论节目.集会的公共场所.提供公开讨论的媒体.法庭.;
conduct	vt.& vi.引导.带领.控制.传导.;vt.组织.安排.实施.执行.;adj.指挥，带领，护送.;vi.（在乐队里）当指挥.（在公共电汽车或火车上）当售票员.指路.;n.举止.行为.管理（方式）.实施（方式）.;
donate	vt.& vi.（尤指向慈善机构）捐赠.献（血）.捐（血）.捐献（器官）.;n.捐赠.捐献.;
contributing	adj.贡献的，起作用的.;v.捐献( contribute的现在分词 ).捐助.撰稿.投稿.;
beta	n.贝塔，希腊字母中的第二个字母.;
html	abbr.Hypertext Markup Language 超文本链接标示语言.;
css	abbr.control-stick steering 操纵杆控制.combat service support 战斗勤务支援.coded switch system 密码转接系统.cryogenic storage system 冷冻贮藏系统.;
license	n.许可证，执照.特许.;vt.同意.发许可证.;
donation	n.捐赠，赠送.捐款.捐赠物.;
grasp	vt.抓住.了解.急忙抓住.急切（或贪婪）地抓住.;n.控制.控制力.能力所及.;vi.攫取（常与 at 连用）.急于接受.急切地寻求（常与 for 连用）.;
regularly	adv.有规律地，按时，照例，按部就班地.整齐地，有条不紊地.经常，不断地.定期地.;
proficiency	n.熟练，精通，娴熟.;
recommend	vt.推荐,介绍,劝告,使受欢迎,托付,使...受欢迎,使...可取
submit	vi.顺从，服从.甘受，忍受.;vt.使服从，使顺从.提交，呈送.[法]主张，建议.;
request	n.要求.需要.所请求的事物.申请书.;vt.（下级对上级的）请求.请求得到.索取.邀请[常接不定式或从句].;
frequently	adv.频繁地，屡次地.往往.动.动辄.;
deferred	adj.延期的，缓召的.;v.拖延，延缓，推迟( defer的过去式和过去分词 ).服从某人的意愿，遵从.;
widget	n.小器具,装饰品n.[计]窗口小部件
chaffer	n.讲价.;v.讲价，吹毛求疵.;
rosa	abbr.recording optical-spectrum analyzer 光谱分析记录.;
succinctly	adv.简洁地.简洁地，简便地.;
hosting	n.群众或部队的集合，作战.;
