Immediately Invoked Function Expression）；IIFE;
correctly	adv.正确地，得体地.实事求是.;
desirable	adj.令人满意的.值得拥有的.可取的.性感的.;n.称心如意的人[东西].;
anonymous	adj.无名的.假名的.匿名的.没有特色的.;
detraction	n.诽谤.;
natural	adj.自然的.物质的.天生的.不做作的.;n.自然的事情.（生来的）白痴.[乐]（风琴等的）白键.;
seem	v.好像，仿佛.似乎.装作.看来好像.;
knee	n.膝.膝盖.;vt.用膝盖碰.;
off	adj.远的,空闲的,不工作的adv.离开,在远方,离去,分离,中断,完成 prep.从...离开,脱离
cut	vt.& vi.将（某物）切开（或分割）.;vt.削减.剪切.切成.删剪.;vi.电影.（为决定谁先出牌等）切牌.可被切割.可用于切割.;n.切口.削减.剪裁.切片.;
verbosity	n.冗长，赘言.;
trouble	n.烦恼,麻烦,动乱,纠纷,疾病,故障,问题vt.(使)烦恼,麻烦,打扰,麻烦自己,费神,费心
conflate	vt.合并，混合.;
confuse	vt.使困窘.使混乱.使困惑.使更难于理解.;vi.使糊涂.;
codify	vt.把（法律）编成法典.编成法典.;
shown	 vbl.show的过去分词
correct	adj.正确的.合适的.符合公认准则的.得体的.;v.改正.批改.指出错误.;
inherit	vt.& vi.继承.;vt.经遗传获得（品质、身体特征等），继任.;
unpredictable	adj.无法预言的.不可预测的.;n.不可预测的事.;
unbound	adj.无束缚的.<正>不负有义务的.;v.解开，解放( unbind的过去式和过去分词 ).;
whatever	 pron.凡是...,无论什么adj.无论怎样的,无论哪一种的,什么也
discard	vt.丢弃，抛弃.解雇.出牌.;n.被抛弃的人[物].丢弃，抛弃.打出的牌.打出的牌.;vi.出无用的牌.垫牌.;
count	v.数,计算,计算在内,认为,有价值n.计数,计算,注意,伯爵
sol	n.[音]大音阶的第五音,[化]溶胶
repeated	adj.反复的，再三的，重复的.累.频仍.;
binding	n.捆绑.（衣服等的）镶边.粘合剂.书籍的封面.;adj.捆绑的.粘合的.（书面材料）有约束力的.应履行的.;v.约束( bind的现在分词).装订.捆绑.（用长布条）缠绕.;
loss	n.损失,遗失,失败,输,浪费,错过,[军]伤亡,降低
id	n.遗传素质,本能冲动n.身份证,标识符 [域] Indonesia ,印度尼西亚  身分,身份 ID(identification,identity)
suffer	vi.受痛苦.受损害.变糟.变差.;vt.忍受.容忍.容许.遭受.;
briefly	adv.短暂地.简单地.简略地.略略.;
dec	abbr.decrease 减少.decorate 装饰.decoration 装饰.decorative 装饰的.;
keystroke	n.[计]键击,按键
saving	n.存款,挽救,救助,节约adj.搭救的,挽救的,节约的,节俭的,保留的,补偿的 prep.除...之外,考虑到
sarcasm	n.讥讽.讽刺话.;
verbose	adj.冗长的，啰唆的，累赘的.;adv.冗长地，啰唆地，累赘地.;
tediously	adv.沉闷地，长而乏味地.;
arrow	n.矢，箭.箭状物.箭头记号.[天]天箭座.;
fat	n.脂肪,肥肉;adj.肥大的,丰满的,肥的,胖的,油腻的;vt.养肥,在...中加入脂肪;vi.长肥;File Allocation Table,文件分配表
chang	n.青稞酒(亦作chong)
overwrite	v.写在...上面,写得过多n.推销佣金
usage	n.使用.用法.习惯.惯例.;
collision	n.碰撞.冲突.（意见，看法）的抵触.（政党等的）倾轧.;
end	n.<正>结果.端.终止.最后部分.;vt.& vi.结束，终止.;
controlled	adj.受约束的，克制的.;v.控制( control的过去式和过去分词 ).管理.限制.克制.;
influence	n.影响,感化,势力,有影响的人(或事),(电磁)感应vt.影响,改变
proper	adj.适当的，相当的，正当的，应该的，正式的，正常的.固有的，特有的，独特的.本来的，真正的，严格意义上的.〈古〉漂亮的，优美的.;adv.〈方〉适当地，好好地，非常，很，完完全全地，彻底地.;n.[宗教][常用P-]特定节日等用的仪式，弥撒（祈祷、礼仪等）书的章节，特赞.;
precondition	n.前提.先决条件.;vt.预先处理.事先准备.;
intentionally	adv.有意地，故意地.;
dangerous	adj.危险的.;
unnecessary	adj.不必要的，多余的.无用的，无益的.无须.;
discourage	vt.使气馁.使沮丧.阻碍.劝阻.;
private	adj.私有的，私人的.秘密的.内心的.平民的，无官职的，士兵的.;n.列兵，士兵，[陆]二等兵.〈古〉私人，个人.阴部，生殖器.;
violate	vt.违犯,亵渎(圣物),冒犯,干扰,违反,妨碍,侵犯,强暴
choice	n.选择,抉择,精选品,选择机会,选择权adj.精选的,上等的,挑三拣四的,可选的,宠爱的,爱惜的
extend	vt.& vi.延伸.扩大.推广.;vt.伸展.给予.延长.发出（邀请、欢迎等）.;vi.伸出.延伸.增加.;
everything	pron.每件事物.最重要的东西.（有关的）一切.万事.;
minimally	adv.最低限度地，最低程度地.;
expose	vt.揭露，揭发.使暴露.使遭受.使曝光.;
api	abbr.acceptable periodic inspection 合意周期检查.armor-piercing incendiary tracer 追踪式穿甲燃烧弹.;
authority	n.权威,威信,权威人士,权力,职权,典据,著作权威
sometimes	adv.有时，间或.时而.;
privilege	n.特权,特别待遇,基本公民权力,特免vt.给与...特权,特免
least	adj.最小的.最少的（ little的最高级）.最不重要的，地位最低的.;adv.最少，最小.;n.最小.最少量.;
principle	n.原则，原理.准则，道义.道德标准.本能.;
arise	vi.& vt.产生.出现.起身，起立.起源于，产生于.;
motivate	v.激发
reason	n.理由,原因,动机,理智,前提vt.说服,推论,辩论vi.推论,劝说,思考
variety	n.多样.种类.杂耍.变化，多样化.;
tied	v.（用线、绳等）系( tie的过去式和过去分词 ).;
hide	vt.隐藏.躲避，隐匿，躲藏.遮蔽，覆盖.;vi.隐瞒.遮住.遮挡.掩盖.;n.兽皮.<口>生命.<口>人的皮肤.（观看野生动物的）隐蔽处.;
wrap	n.外套,围巾,包裹,秘密,约束,限制vt.包装,卷,缠绕,包,覆盖,裹,遮蔽,隐藏vi.缠绕,重叠,穿外衣,包起来
arbitrary	adj.随意的，任性的，随心所欲的.主观的，武断的.霸道的，专制的，专横的，独断独行的.乱.;
powerful	adj.强大的.权力大的.（药）有效地.;adv.很.非常.;
inverse	adj.相反的.逆向的.倒转的.;n.相反.倒转.相反的事物.;vt.使倒转.使颠倒.;
pit	n.深坑,深渊,陷阱,(物体或人体表面上的)凹陷,(英国剧场的)正厅后排、正厅后排的观众vt.窖藏,使凹下,去...之核,使留疤痕,使竞争vi.起凹点,凹陷
unexpected	adj.想不到的，料不到的.意外的.忽然的.突然的.;
ist	abbr.istituto (Italian=institute) （意大利语）机构.;
useful	adj.有用的，有益的，有帮助的.令人满意的.;
entirety	n.整体，全面.作为一个整体.完全.;
throughout	 prep.遍及,贯穿adv.到处,始终,全部
reuse	vt.再用，重新使用.;n.再用，重新使用.;
attached	adj.附加的，附属的.依恋的.爱慕的.;v.贴上，系，附上( attach的过去式和过去分词).;
belong	vi.属于,住
implication	n.含义.含蓄，含意，言外之意.卷入，牵连，牵涉，纠缠.[逻辑学]蕴涵，蕴含.;
ble	abbr.Brotherhood of Locomotive Engineers <美>火车司机兄弟会.;
bub	n.<美口>小弟弟，小家伙.;
nesting	n.嵌套.;v.筑巢( nest的现在分词 ).;
neatly	adv.整洁地,优美的,巧妙的,[酒类]纯的
nest	n.巢,窝,休息所,隐匿处,舒适的地方,(可以一个套一个的)一套器具vi.筑巢,找鸟巢vt.造巢,使套入
bucket	n.水桶.一桶（的量）.大量.〈俚〉交通工具.;v.用桶装，用桶运.倾盆而下.〈美俚〉骗.猛开车，猛划船.;
container	n.容器(箱,盆,罐,壶,桶,坛子),集装箱
act	n.幕,法案,法令,动作,举动,节目,(戏剧的)幕vi.行动,产生...的效果,担当,表演,假装,表现,见效vt.扮演,装作
consist	vi.由...组成,在于,一致
explore	vi.勘查， 探测， 勘探.[医]探查（伤处等），探索，研究.;vt.探索， 探究， 仔细查看.;
pessimistically	adv.悲观地.;
regarding	 prep.关于
defeat	vt.击败，战胜.挫败.[法]宣告无效，作废.;n.战胜.失败.[法]废除.;
downside	n.下降趋势.负面，消极面.;adj.下降趋势的.;
latter	adj.后面的,(两者中)后者的,较后的,近来的
predict	vt.预言，预测.预示，预告.;vi.预言，预示：预言某事，预言.;
effects	n.动产，财物，家财.结果( effect的名词复数 ).效果.感受.个人财产.;
limit	n.限制.限量，限度.界限.;vt.限制，限定.;
smart	n.刺痛,痛苦adj.巧妙的,聪明的,漂亮的,潇洒的,刺痛的,剧烈的,厉害的,敏捷的vi.刺痛,懊恼 轻快地,严厉地,灵巧地,精确的,时髦地,大大的
slower	v.减慢
present	adj.现在的.目前的.出席的.[语法学]现在时的.;n.现在.礼物.瞄准.;vt.介绍.出现.提出.赠送.;vi.举枪瞄准.;
pointless	adj.无意义的.不得要领的.钝的.无谓.;
sense	n.感觉，官能.意识，观念.理性.识别力.;vt.感到.理解，领会.检测出.;
pessimistic	adj.悲观的，厌世的.悲观主义的.;
invalid	adj.无效的.不能成立的.有病的.病人用的.;vt.使伤残.使退役.失去健康.;n.病人，病号.残废者.伤病军人.;vi.变得病弱.因病而奉命退役.;
awareness	n.察觉，觉悟，意识.;
effort	n.努力，尝试.工作.成就.杰作.;
analyze	vt.分析,分解
boil	n.煮沸，沸腾.疔，疖子.[医]疡肿，脓肿.;vt.& vi.（使）沸腾，开.;vt.用开水煮，在沸水中煮.;vi.怒火中烧，异常气愤.;
optimization	n.最佳化，最优化.优选法.优化组合.;
flexibility	n.柔韧性，机动性，灵活性.伸缩性.可塑度.柔度.;
big	adj.大的.重要的.（计划）庞大的.大方的.;adv.大量地.成功地.夸大地.宽宏大量地.;n.大亨.大公司.;
functionality	n.（计算机或电子系统的）功能.功能性.设计目的.实用.;
retain	vt.保持.留在心中，记住.雇用.付定金保留.;
unsafe	adj.不安全的.危险的.不安稳的.;
indirect	adj.间接的.不直截了当的.闪烁其词的.不坦率的.;
low	adj.低的，矮小的.楼下的，低洼的.沮丧的.下贱的.;adv.低声地.谦卑地.底下地.;n.低点.低水平.牛的叫声.;vi.（牛）哞哞叫.;
outright	adv.完全地.彻底地.坦率地，不客气地.即刻，马上.;adj.完全的，彻底的.直率的.明白的.总共的.;
restricted	adj.有受限制的.（土地）对公众不完全开放的.保密的.;v.限制( restrict的过去式).;
affected	adj.受到影响的,受(疾病)侵袭的,假装的,做作的
addition	n.加，增加，附加.[数]加法.增加的人或事物.;
explanation	n.解释.说明.辩解.（消除误会后）和解.;
thought	n.思想.想法.关心.思索.;v.想( think的过去式和过去分词).思索.以为.认为.;
bend	vt.（使）弯曲，屈身.拉弯.使成形，强行.集中全力于.;vi.偏向.使变曲，成角度.弯身，弯腰.专心.;n.弯曲（处）.（尤指道路或河流的）拐弯.弯道.（潜水员过快浮出水面造成的）减压病.;
mind	n.心，精神，心力，知，智力，智慧.心胸，头脑，人.愿望，目的，意向，意志，决心，见解，意见.记忆，记性，记忆力，回想.;vi.介意.注意.;vt.专心于.介意.愿意做.照顾.;
sort	n.种类,类别v.分类,拣选
strange	adj.陌生的，生疏的.奇怪的，古怪的.疏远的.外国的.;adv.奇怪地.陌生地.冷淡地.;
neither	adj.pron.两者都不 conj.既不...又不,也不
correspond	vi.符合,协调,通信,相当,相应
air	n.天空.气氛.空运.（简单易记的）曲调.;vt.& vi.晾晒.烘干.播送.广播.;vt.使房间通风， 透气.;
thin	adj.薄的,细的,瘦的,稀少的,稀疏的,(液体、气体)稀薄的,淡的,空洞的vt.使变薄,使变细,使稀少,使淡vi.变薄,变细,稀少,变淡adv.薄地,稀疏地,微弱地n.细小部分
whole	n.全部,全体,整体,完全之体系adj.所有的,完整的,完全的,纯粹的,未损伤的,未打破的adv.完全,整个
wholly	adv.完全地，全部地.十足，统统.专门.一并.;
zero	n.（数字）0.零度.;adj.全无的，没有的.;v. .聚焦，集中.;
peculiar	adj.奇怪的，古怪的.异常的.特有的，特殊的.;n.专有特权，专有财产.[多用于英国]特殊教堂.;
remains	n.遗骨，遗体，残骸，残余，遗迹.废墟，遗址，遗迹，剩余（物），余额.;v.留下( remain 的第三人称单数).保持.留待.仍然是.;
reflected	adj.反射的，得自他人的.;v.反射（光、热、声或影像）( reflect的过去式和过去分词 ).考虑.反照.表达.;
ter	n.=terr adv.[医]三次
leak	vi.漏出.透露.（指消息，秘密等）泄密.漏电，漏水.;vt.使泄露.<非正式> 擅自公开.;n.泄漏，漏洞.裂缝.漏出物.（俚语）撒尿.;
oops	int.表示惊讶,狼狈时所发的喊声
convenient	adj.方便的.[废语]适当的.[口语]近便的.实用的.;
short	n.简略,短路,短裤adj.短的,矮的,不足的,不够的,(智力等)弱的,浅薄的,松脆的,简短adv.突然,缺乏,不足
repeat	vt.复述，背诵.重复.;vi.重做.重复投票.;n.（节目）重演.重复.重复的事物.;
tedious	adj.单调沉闷的.冗长乏味的.令人生厌的.;
repeating	adj.反复的，重复的.;v.重做( repeat的现在分词 ).复述.重说.重复发生.;
prop	n.支柱，支撑物.支持者，后盾，靠山.道具.（橄榄球中的）支柱前锋.;vt.支撑，支持，维持.使倚靠在某物上.;
shorthand	n.速记，速记法.速记记录文字.;adj.速记法的.;
perspective	n.透镜，望远镜.观点，看法.远景，景色.洞察力.;adj.（按照）透视画法的.透视的.;
choose	v.选择,选定
valid	adj.有效的.有法律效力的.正当的.健全的.;
keyword	n.关键字.关键词.;
worth	 prep.相当...价值n.价值,财产adj.值钱的,值的看中的
almost	adv.几乎，差不多.将近.快要.近乎.;
degradation	n.堕落.潦倒.毁坏.恶化.;
rare	adj.罕见的，特殊的.优秀的，不寻常的.稀薄的，经过稀化的.;
incredibly	adv.难以置信地，很，极为.;
avoid	vt.避开，避免，预防.[法]使无效，撤销，废止.;
constructor	 [计] 构造器
deprecate	vt.抗议,不赞成,抨击,反对,藐视,轻视
since	adv.以后,后来,以前 prep.自从,自...以来 conj.自...以后,自...以来,因为,既然
legacy	n.遗赠(物),遗产(祖先传下来)
evaluate	vt.评价,估计,求...的值v.评价
respective	adj.各自的，分别的.;
effect	n.结果,效果,作用,影响,(在视听方面给人流下的)印象vt.招致,实现,达到(目的等)
similar	adj.类似的.同类的.相似的.同样的.;n.类似物.相像的人.相似物.;
facility	n.容易,简易,灵巧,熟练,便利,敏捷,设备,工具
enclose	vt.放入封套,装入,围绕
own	n.自己的事物.自己人.;vt.拥有.承认.;vi.承认.;adj.自己的.特有的.;
operate	v.操作,运转,开动,起作用,动手术,开刀n.[军]作军事行动
cause	n.原因,导致某事发生的人或事,动机,理由,根据,目标,理想,事业vt.引起,惹起,使(发生),促成
through	prep.通过，穿过.经由.透过.凭借.;adv.从头到尾.彻底.自始至终.;adj.（电话）接通.通话完毕.有洞的.直达的.;
reside	vi.住，居住，（官吏）留驻，驻在.（性质）存在，具备，（权力，权利等）属于，归于.;
contain	vt.包含,容纳,容忍vi.自制v.[军]牵制(敌军)v.[数]可被...除尽
default	vi.未履行任务或责任.受传唤时未出庭.由于不到庭而败诉.弃权.;vt.未履行，拖欠.未参加或完成（例如，比赛）.[法]因未到庭而败（诉）.;n.未履行，拖欠.[法]未到庭.弃权.[计] 缺省，默认.;
benefit	n.利益，好处.救济金，津贴.义演，义卖.恩惠，恩泽.;vt.有益于，有助于.使受益.得益，受益.;
real	adj.真的.真实的，现实的.事实上的.真诚的.;adv.真正，实在.确实地.;n.实在，现实.实数.;
static	adj.静止的.不变的.静电的.[物]静力的.;n.静电.[物]静电（干扰）.静力学.争吵.;
essentially	adv.本质上,本来
dynamical	adj.动力（学）的，有力量的.;
logic	n.逻辑，逻辑学.（做某事的）道理.推理方法.威力，压力，强制（力）.;adj.逻辑的.;
easily	adv.容易地.很可能.迅速地.频繁地.;
literal	adj.照字面的.原义的.逐字的.平实的，避免夸张.;n.[印]错排，文字上的错误.;
pass	n.经过,关口,途径,护照,通行证,入场券,传球,及格vt.通过,审查通过,忽略,传递vi.经过,变化,流通,宣判,被忽略,终止,传递,不叫牌
normally	adv.正常地.通常地，一般地.按说.论理.;
print	n.版,印刷物,印迹,印章,印刷业,照片v.印刷,出版,印于,用印刷体写 [计]打印
existing	adj.目前的.现存的.;v.存在( exist的现在分词).持续存在.;
str	abbr.structure 结构.string(s) 线.straight 直（的）.structural 结构（上）的.;
dy	abbr.day 天.duty 义务.dynamotor 电动发电机.delivery 递送.;
subsequent	adj.后来的.随后的.作为结果而发生的.附随的.;
along	adv.往前,向前 prep.顺着,沿着
pretend	vt.假装，伪装.假称.装扮.;vi.扮演.自称.假装，矫作.;adj.仿制的.;
allow	vt.允许.承认.给予.准许（做某事）.;vi.容许.考虑.;
clear	adj.清楚的，明白的.清晰的，明亮的.清澈的.明确的.;adv.完全地.清晰地.整整.;vi.变明朗.变清澈.;vt.扫除，除去.消除（嫌疑）.使清楚.使干净.;n.空隙，空间.;
light	n.光.发光体.电灯.点火器.;adj.轻的.明亮的.浅色的.少量的.;v.点燃.照亮.用光指引.;adv.轻地，轻装地.;
intended	adj.有意的.预期的.;n.已订婚者.;v.打算(intend的过去式和过去分词).意指.;
pun	n.双关语.俏皮话.;vi.说双关语.;vt.捣结实.;
evaluating	vbl.评估,评价,评测
generate	vt.形成，造成.产生物理反应.产生（后代）.引起.;
issue	n.出版,发行,(报刊等)期、号,论点,问题,结果,(水,血等的)流出vi.发行,流出,造成...结果,进行辩护,传下vt.使流出,放出,发行(钞票等),发布(命令),出版(书等)发给 [律]子女,后嗣
explain	v.解释,说明
poor	adj.贫穷的，贫乏的.令人怜悯的，可怜的.匮乏的.低劣的.;n.the poor 贫困者，穷人.;
lead	vt.领导,引导,致使vi.领导,(道路等)通向,导致,用水砣测深n.领导,领先,导线,铅,(自船上测海水深度的)铅陲,石墨,铅笔芯
missing	adj.失去的.下落不明的.;v.错过( miss的现在分词).;
typical	adj.典型的.特有的或特别的.代表性的.;
bad	adj.坏的，不好的.严重的.不舒服的.低劣的，有害的.;n.坏人，坏事.;adv.不好地，非常地.;
community	n.公社,团体,社会,(政治)共同体,共有,一致,共同体,(生物)群落
wider	adj.宽的，广阔的(wide的比较级).;
equally	adv.相等地.平等地.公正地.平均.;
mechanism	n.[生]机制，机能，[乐]机理.（机械）结构，机械装置[作用]，（故事的）结构.[艺]手法，技巧，途径.机械作用.;
possibly	adv.可能地.也许，或许.敢是.容许.;
decision	n.决定.果断.决议.（法院的）判决.;vt.[口语][拳击]靠判定击败（对手）.;
respectively	adv.各自地.各个地.分别地.;
locate	vt.查找...的地点,使...坐落于,位于v.定位,位于
piece	n.块，片，段.部分，部件.文章，音乐作品.;vt.修补.连接，接上.;
class	n.班级,阶级,社会等级,种类,(一节)课vt.把...分类(或分等级)
apply	vt.应用，运用.申请.涂.敷（药）.;vi.申请，请求，适用.适用，适合.专心致志.;
non	adv.非，不.;n.[法]反对票，投反对票的人.;
due	adj.由于.适当的.预定.到期.;n.应有的权利.应得到的东西.应缴款.;adv.正向.正对着.;
inaccessible	adj.达不到的.难见到的.不能接近的.无法理解的.;
indirectly	adv.间接地.迂回地.婉转地.不坦率地.;
stead	n.代替.用处，好处.有帮助.;v.对。。有用.;
directly	adv.直接地,立即
possible	adj.可能的.可接受的.合理的，可以允许的.不坏的.;n.可能性，潜在性.可能的人物，可能有的事.最高分.;
window	n.窗，窗户.窗口.〈美俚〉眼镜.;
glob	n.一滴，一小滴水珠，（可塑性物质的）一团.;
properties	n.房地产(property的名词复数).财产.所有权.特性.;
automatically	adv.自动地.无意识地.不自觉地.机械地.;
upward	adj.向上的，上升的.升高的.;adv.向上地，上升地.;
outward	adj.向外的.外面的.公开的.[宗]肉体上的.;adv.向外（等于outwards）.在外.;n.外表.外面.物质世界.;
layer	n.层,阶层
multiple	adj.多重的.多个的.复杂的.多功能的.;n.<数>倍数.[电工学]并联.连锁商店.下有多个分社的旅行社.;
match	n.比赛.对手.相配的人（或物）.火柴.;vt.相同.适应.使较量.使等同于.;vt.& vi.使相配，使相称.;
near	adv.（空间）在近处.在附近.（时间）临近.（程度）几乎.;prep.（表示程度）接近.（表示位置）靠近.（表示时间）将近.接近于（某种状态）.;adj.近的.亲密的.近似.（亲属关系）近亲.;
won	v.获胜，战胜（ win的过去式和过去分词 ）.;
innermost	adj.最深处的.隐私的，最隐秘的.;
referenced	adj.参考的，引用的.;
goes	v.进行（go的第三人称单数）.去.离开.进展.;n.（牌戏、下棋等中）轮到的顺序（go的复数形式）.;
sole	adj.单独的,唯一的n.脚底,鞋底,基础v.换鞋底
place	n.地方,地点,位置,职位,处境,住所,地位vt.放置,寄予,任命vi.名次列前
ex	prep.不包括,无权得到
placement	n.安置，放置.实习工作，实习课.定位，[足]定位球.;
relative	adj.相关的.相对的.相互有关的.比较而言的.;n.亲属，亲戚.相关物.亲缘植物（或动物）.[语法学]关系词.;
parent	n.父亲（或母亲）.先辈.根源，起源.保护者.;
ally	n.同盟国，同盟者.助手，支持者.协约国.联盟.;vt.&vi.（使）联盟，（使）同盟.（使）结盟，（使）联姻.;
parti	n.<法>合适的婚姻对象，（结婚的）理想配偶.;
boundary	n.分界线.范围.（球场）边线.;
cross	n.十字架.十字形饰物.杂交品种.痛苦.;vi.交错而行.横渡.越境.;vt.杂交.横跨，穿越.划掉.使相交.;adj.坏脾气的， 易怒的.相反的，反向的.;
diagram	n.图表.图解.示意图.[数]线图.;vt.用图表示.图解.;
venn	diagram(s)（数）（用圆表示集与集之间关系的）维恩图.;[人名] [英格兰人姓氏] 维恩 Fenn的变体.[地名] [加拿大、南非共和国] 文恩.;
talking	n.讲话.（表示对所说的事情感兴趣） 你这话说着了.提起.说到.;adj.会说话的.讲话的.饶舌的.富于表情的.;v.说( talk的现在分词 ).讨论.说话.（用以强调款额、情况严重程度等）讲的是.;
strictly	adv.严格地.完全地.;
chose	v.挑选（ choose的过去式 ）.选择.选定.喜欢.;
units	n.单位.[药剂学]（药物、疫苗、血清、抗原等的）单位( unit的名词复数 ).装置.一件（商品）.（栋公寓大楼中的一套公寓）单元.;
written	vbl.write的过去分词
encompass	vt.围绕，包围.包含或包括某事物.完成.;
bubble	n.泡，水泡.冒泡，起泡.泡影，妄想.（欲表达的）一点感情.;vt.& vi.起泡，使冒气泡.;vi.使冒泡，发出冒泡的声音.洋溢着（某种感情）.滔滔不绝地讲.兴奋，欢闹.;
inherent	adj.固有的,内在的,与生俱来的
bar	n.条,棒(常用作栅栏,扣栓物),横木,酒吧间,栅,障碍物vt.禁止,阻挡,妨碍,把门关住,除...之外,(Bar)律师业 /n.条形/柱形图
nature	n.自然,自然界,大自然,自然状态,本性,天性,种类
entirely	adv.完全地.完整地.全部地.彻底地.;
practice	n.练习.实践.（医生或律师的）业务.惯例.;vi.实行.惯常地进行.练习.实习.;vt.实行，实践.执业.练习.惯常地进行.;
upon	 prep.在...之上
frown	vt.& vi.皱眉.不同意.蹙额.;n.皱眉，蹙额.;
after	adv.prep.conj.在...之后,在...后面,模仿,与...一致,以...命名,后来的,后面的
thereby	adv.因此,从而,在那方面,在那附近
stone	n.石头.宝石.矿石.（膀胱或肾脏中的）结石.;vt.向扔石块.用石头铺.以石掷向.除（水果的）硬核.;adj.石制的.石头似的.[S-]石器时代的.粗陶制的.;adv.石一般的.;
based	v.立基于,基于...,以...为基础,vbl.建立,装置
circularly	adv.圆地，循环地.;
foundation	n.基础,根本,建立,创立,地基,基金,基金会
semantic	adj.<语>语义的，语义学的.;
recall	vt.叫回，召回.使想起，回想.取消.调回工厂.;n.召回，唤回.记忆力，回想.罢免.收回通告.;
standard	n.标准，规格.旗，军旗.度量衡标准.直立支柱.;adj.标准的，合格的.普遍的，一般的.公认为优秀的.;
phase	n.相，周相.阶段.[物理学]相位.方面，侧面.;vt.分阶段实行.调整相位.;vi.分阶段进行.;
discus	n.铁饼,掷铁饼
employ	vt.雇用.使用，利用.;n.受雇.服务.工作.;
provide	vt.& vi.提供，供给，供应.;vt.规定.提供(+for).装备.预备.;vi.抚养，赡养(+for).做准备.预约(for 或 against).;
mention	vt.提及,说起n.提及,说起v.论及,提及
appendix	n.附录,附属品,[解]阑尾
bash	vt.痛击，猛击.严厉批评.怒殴.;vi.严厉地，威胁地批评指责.;n.重击，猛撞.痛快的玩乐[消遣].<英方>尝试.;
still	adv.仍，仍然.更，还要.静静地.〈诗〉常，不断地.;adj.不动的，静止的.不狂暴的，温柔的.没有活力的，死气沉沉的.;n.平静，寂静.剧照.静止摄影.蒸馏器.;vt.& vi.（使某物）平静下来，安静.〈古〉烧（酒），蒸馏.;conj.但是.然而.;
examine	vt.检查，调查.考试.诊察.审问.;vi.检查.调查.;
majority	n.多数.（获胜的）票数.成年.法定年龄.;
vast	adj.广阔的.巨大的.大量的.巨额的.;n.浩瀚.广大无边的空间.;
model	n.样式,型,模范,典型,模型,原型,模特儿vt.模仿v.模拟
predominant	adj.主要的，占主导地位的.占优势的，卓越的.有影响的.特优种.;
govern	vt.统治.管理.治理.支配（词或短语的形式或用法）.;vi.控制，支配.操纵.;
beginning	n.开始.根源.原始思想.前兆.;v.开始( begin的现在分词).;
separate	vt.& vi.分开.（使）分离.区分.隔开.;vt.分离（混合物）.分居.分类.割开.;vi.分手.断裂.（夫妻）分居.断绝关系.;adj.单独的.分开的，分离的.不同的.不相关的.;n.分开的事物.[用复数]（音响设备中的）独立件.;
split	vt.分裂.分开.<俚>（迅速）离开.分担.;n.划分.分歧.裂缝.劈叉.;vi.<俚>走开.揭发.被撞碎.<美>[证券]（股票）增加发行.;adj.裂开的，劈开的，分离的，分裂的.;
determine	vt.& vi.（使）下决心，（使）做出决定.;vt.决定，确定.判定，判决.使决定.限定.;vi.[主用于法律]了结，终止，结束.;
against	 prep.相反,反对,逆着,靠着,倚着
attempt	vt.试图.尝试.;n.进攻.尝试，冲击.;
illegal	adj.不合法的，违法的.违反规则的.;n.非法移民，非法劳工.间谍.;
successful	adj.成功的，如愿以偿的.;
failure	n.失败，不及格.缺乏，不足.破产，倒闭.失败的事，失败者.;
undefined	adj.未阐明的.未限定的.;
null	adj.<术>零值的.等于零的.（协议） 无法律效力.失效的.;
impossible	adj.不可能的，做不到的.难以忍受的.不会有的，不能相信的.;n.不可能.不可能的事.;
try	vt.& vi.试图，努力.实验.审判.考验.;n.尝试，实验.[橄]触球，（因触球获得的）向球门踢球的权利.;
similarly	adv.相似地.类似地.;
throw	vi.投掷.丢.抛.;n.投掷的距离.丢.;vt.掷（色子）.抛.猛动（头、臂、腿）.使处于，使限于.;
creation	n.制造，创造.创造物，产物.（尤指<圣经>所述由上帝）创造天地，宇宙.（爵位等的）封授.;
implicit	adj.不言明[含蓄]的.无疑问的，绝对的.成为一部份的.内含的.;
automatic	adj.自动的.不假思索的，无意识的.必然发生的.;n.自动化机器或设备.自动手枪.;
disallow	vt.不接受.不准.驳回.;
behavior	n.行为.态度.（机器等的）运转状态.（事物的）反应.;
relaxed	adj.（人）轻松的.自在的.无拘无束的.舒适的.;adv.轻松地.自在地.舒适地.随便地.;vt.（使）轻松( relax的过去式).（使）松弛.放宽.（使）放松.;vi.松散.松弛.放宽.放松.;
number	n.数,数字,数量,号码,算术,诗,韵律v.遍号码,共计...,计入,计算,算入
created	adj.创造的.;v.创造( create的过去式和过去分词 ).引起.造成.封.;
arrive	vi.到达，来.发生.;
thrown	v.投( throw的过去分词 ).掷.扔.抛.;
anywhere	adv.什么地方.任何地方.无论何处.〈口〉（用于否定句〕根本(不）.;
fail	vt.& vi.失败，不及格.倒闭，破产.缺乏.衰退.;vi.衰退.失败，不及格.破产.不足.;vt.不及格.使失望.忘记.舍弃.;n.失败，失误.不及格.不及格者.[商]期货交割失期.;
undeclared	adj.未申报的，未经宣战的.;
stance	n.态度，立场.站姿，被放置的姿势.位置.（运动员的）始发姿势.;
matter	n.事件,问题,物质,内容,实质,原因,(印刷或书写的)文件,(文章或讲话等的)素材vi.有关系,要紧
regardless	adv.不顾后果地.不管怎样，无论如何.不惜费用地.;adj.不重视的，不尊敬的.不顾虑的，不关心的.不受注意的，毫无价值的.;
either	adj.任一的,(两方中的)每一方的 pron.任一,随便任一个 conj.或者,也
elevator	n.电梯.升降机（美）.谷仓.;
resolve	vt.& vi.决定.决心.;vt.使消释.使分解，使解体.（指委员会或集会）表决.消退（炎症等）.;vi.下决定.分解.;n.决意，决定.（会议等的）决议.;
floor	n.(房间,走廊等的)地面,地板,基底,(室内的)场地,层,海底,议员席vt.在...上铺(地板),击倒,(被困难)难倒
tall	adj.身材高的，高大的.（数量）大的.（俚）过分的，夸张的.;adv.夸大地.趾高气扬地.;
visualize	vt.形成思维图像.设想.使可见.;vi.形成思维图像.;
metaphor	n.[修辞]隐喻,暗喻,比喻说话
building	n.建筑物.楼房.房屋.建筑（艺术或行业）.;v.build的现在分词.;
stop	vi.停止.中断.逗留.（使）停止工作.;vt.塞住.堵塞.阻挠.止付.;n.停止.（管风琴的）音栓.停车站.（管风琴的）音管.;
search	v.搜寻，搜索.调查.搜查.探求.;n.搜索.调查.探求.;
keep	n.保持,保养,生计,监狱,[史]要塞vt.保持,保存,遵守,经营,看守,拘留,维持,记(日记,帐等)vi.保持,继续不断
rent	v.租,租借,出租n.租金
cur	光标资源文件n.杂种,坏种,恶狗,卑贱的人,胆怯的家伙
traversing	v.横越，穿越，横贯( traverse的现在分词 ).（爬山时）作Z形攀登.;
yep	adv.<俚>是.;
oh	int.（表示恐惧、惊讶、疑虑等）噢.啊.哎呀.冠于人名前，起呼语作用.;
fish	n.鱼，鱼肉，鱼类.〈口〉（特殊的）人物，家伙，东西.[建]接合板，夹片，鱼尾板.[航]钓锚器，撑夹桅杆的加固夹箍.;vt.& vi.捕鱼.钓鱼.摸出.掏出.;vt.钓鱼，捕鱼.搜寻.[航]加夹箍夹牢.[工]用接合板连接[加固].;vi.捕鱼，钓鱼.用钩捞取.;
nope	adv.不，不是.;
hear	vt.& vi.听到，听见.;vt.听说.得知.听取.审理.;vi.听.听见.;
over	adv.结束,越过,从头到尾 prep.在...之上,越过adj.上面的vt.额外的东西,越过n.额外的东西
revisit	vt.重游.再访.重临.回到.;n.重访问.再参观.;
surrounding	n.围绕物,环境adj.周围的
resolved	adj.下定决心的，断然的.坚决的.已解决的.;v.做决定，分解(resolve的过去式和过去分词).;
reach	n.延伸,区域,河段,范围,(车子前后轴的)联接杆,横风行驶vt.到达,达到,伸出,影响vi.达到,延伸,伸出手,传开
global	adj.全球的，全球性的，有关全球大局的.全面的，整体的，全局的.球形的，球状的，球面的，球体的.[计]全程的.;
outermost	adj.最外面的，离中心最远的.;
until	 prep.到...为止,在...以前 conj.到...为止,在...以前,直到...才
continue	vi.持续.逗留.维持原状.;vt.延期.使延伸.使持续.继续说.;
consult	vi.商议，商量.[医]会诊.咨询.充当顾问.;vt.请教.翻阅.求教于.顾及.;
immediate	adj.立即的.直接的，最接近的.目前的，当前的.直觉的.;
cannot	=can not.未可.不能.不可.;
return	n.回来,返回,来回票,利润,回答adj.返回的,回程的,报答的,反向的,重现的vi.回返,归还vt.归还,回报,报告,获得,回答,返回
play	n.游戏,比赛,运动,赌博,剧本v.玩,扮演,播放,进行比赛v.播放
far	adv.久远地.（问到或谈及距离时说）有多远.到很远距离.到很大程度.;adj.远的.遥远的.（某方向的）最远的.远端的.;n.远方.;
quiz	n.提问，询问.小型考试.简单的小测验.恶作剧.;vt.盘问.挖苦.进行测试.张望.;
cool	adj.冷静的.凉爽的.一流的.孤傲冷漠的.;vt.& vi.（使）变凉.（使）冷静，使冷却.变凉，冷却.平息.;n.凉气，凉快的地方.凉爽，凉爽的空气.;
change	vt.改变，变更.交换，替换.兑换.换衣服（床单）.;vi.改变，转变.交换，互换.换衣，更衣.;n.变化，改变.交换，交替.零钱，找头.代替物.;
double	n.两倍,[计] 双精度型adj.两倍的,双重的vt.使加倍vi.加倍,快步走,加倍努力
yo	int.唷（水手拉绳时一道发出的叫声）.;
ya	abbr.yarn 线.yaw axis 偏航轴.young adults 青壮年.;
built	vbl.build的过去式和过去分词
sorry	adj.对不起的.无价值的，低等的.遗憾的.感到伤心的.;
always	adv.总是，老是.永远，始终.常常.不断地.;
helpful	adj.给予帮助的，有益的.愿意帮忙的.;
recently	adv.最近，近来.不久以前.近日.新近.;
formal	adj.（学校教育或培训）正规的.方式上的.礼仪上的.;n.<美>须穿礼服的社交集会.<口>夜礼服.;
got	v.得到(get的过去式和过去分词).抓住.说服.受到（惩罚等）.;
ok	abbr.ohne kosten (German=without cost) （德语）不计价.不受约束.ola kala (Greek=all is fine, all is good) （希腊语）都很好（古代希腊水手最早使用）.outer keel 外（平板）龙骨.;
thanks	n.感谢，谢谢.感谢，谢谢，道谢的话( thank的名词复数 ).;int.感激（的），致谢（的）.;v.谢谢，感谢( thank的第三人称单数 ).责怪.;
ago	adv.以前.过去的.之前.;
yes	adv.n.是
heard	v.听到，听见( hear的过去式和过去分词 ).听说.得知.听取.;
hey	int.（用以引起注意，表示惊异或询问）嘿，喂.你好！（表示问候）.咳.;n.干草（等于hay）.;
imagine	vt.想，设想.想像.料想，猜想.误认为.;vi.想象.猜想，推测.;
discuss	vt.讨论，谈论.论述，详述.商量.;
appropriate	adj.适当的.恰当的.合适的.;v.盗用.侵吞.拨（专款等） .;
thus	adv.于是，因此.如此，这样，像这样，例如.到这程度，到这地步，这么.如下.;conj.因此.;
necessary	adj.必要的.强制的.必然的.不可避免的.;n.必需品.;
definition	n.定义,解说,精确度,(轮廓影像等的)清晰度
er	symb [化]铒 (erbium)  (英国)伊丽莎白女王 ER(Queen Elizabeth)
involving	v.表明（某人参与了罪行等）( involve的现在分词 ).使参与.牵涉.使专心于.;
tempting	adj.吸引人的.诱人的.;v.引诱或怂恿（某人）干不正当的事( tempt的现在分词).;
normal	adj.正常的.正规的，标准的.[数学]正交的.精神健全的.;n.正常，常态.标准.[数学]法线.;
tempt	vt.诱惑,引诱,吸引,使感兴趣,考验,试探
native	adj.本国的.土著的.天生的.天真的，纯朴的.;n.当地人.土著人.当地产的动（植）物.;
inside	n.里面,内部,内脏,内情adj.内部的,秘密的,于室内工作的adv.在里面 prep.在...之内
exchange	n.交换.交易.交易所.兑换（率）.;vt.交换，互换.兑换.交换，调换.;vi.交换，替换.进行易货贸易，作物物交换.[金融业]（货币）交换，兑换.;
conceptualize	vt.使有概念.;vi.概念化.;
method	n.方法.条理.;
resolution	n.坚定,决心,决定,决议;分辨率
property	n.特性，属性.财产，地产.[戏]道具.所有权.;
object	n.物体,目标,宾语,对象vi.反对,拒绝,抗议vt.提出...来反对
implicitly	adv.含蓄地.暗示地.无疑问地.无保留地.;
parameter	n.[数]参数.<物><数>参量.限制因素.决定因素.;
argument	n.争论,辩论,论据,论点,～ (for,against),意见
implied	adj.暗指的，含蓄的.;v.暗示，暗指( imply的过去式和过去分词 ).必然包含.说明，表明.;
mis	abbr.miscarriage 失败.mistake(n) 误解.metal insulator semicondoctor 金属绝缘半导体.missing 未击中的.;
moreover	adv.再者.此外.而且.同时.;
line	n.绳,索,线路,航线,诗句vt.排成一行,顺...排列,划线于,使有线条,使起皱纹vi.排队
last	adj.最后的,临终的,末尾的,最近的,结论性的vi.持续,支持,维持vt.使维持,楦adv.最后,后来n.最后,末尾,临终,鞋楦头
conceptually	adv.概念地.;
better	adj.较好的.更合适的.能力更强的.好转的.;adv.更好地.更妥.更.;v.胜过.上进.;n.更好者.更有才智者.;
operator	n.操作员,工作者,(电话)接线员,报务员,手术员,行家,经营者,算子
necessarily	adv.必要地.必需地.必定地.必然地.;
left	adj.左边的，左侧的.左派的.;n.左，左面.[军]左翼.左派，激进分子.;adv.向左.在左边.;v.离开( leave的过去式和过去分词).;
meaning	n.意思，意义.含义.意图.;adj.有意思的.意味深长的.;vt.意味(mean的现在分词).意思是.;
want	vt.想要,希望,需要,短缺,缺少n.需要,短缺
care	n.注意,照料,烦恼,忧虑,由...转交vi.关心,顾虑,照顾,喜爱vt.在意
contrast	vt.使与...对比,使与...对照vi.和...形成对照n.对比,对照,(对照中的)差异
passe	adj.已过盛年的，凋谢的.;
signed	adj.[计] 有符号的,有正负之分的
nothing	pron.没有东西.没有事情.无关紧要的东西.毫无趣味的事.;n.无关紧要的人[事].零.无.;adv.毫不.决不.;
reference	n.参考.参考书.提及，涉及.证明人，介绍人.;v.引用.参照.;
log	n.航行日志,原木,园形木材,园木v.把...记入航行日志,伐木,把...锯成段
console	vt.安慰，慰问.;n.控制台，操纵台.演奏台.悬臂.肘托.;
go	vi.离去,走,进行,变成,趋于,达到,求助于,诉诸vt.以...打赌,忍受,出产n.去,进行
imply	vt.& vi.暗示.意味.隐含.说明，表明.;
her	pron.(she的宾格)她.(she的所有格)她的.她，指某个国家，（一艘）船.;
moment	n.瞬间，片刻.时刻.重要，紧要.[物]力矩.;
glib	adj.<贬>（演讲者或演讲）油腔滑调的.不诚恳的.未经思考的.肤浅的.;
slightly	adv.轻微地，轻轻地.细长地，苗条地.〈罕〉轻蔑地.粗.;
means	n.方法（ mean的名词复数）.手段.收入.财富.;v.意味着（ mean的第三人称单数）.引起.打算或注定要某人成为或做某事.;
accurately	adv.正确无误地，准确地.精确地.如实.;
se	abbr.Sweden 瑞典.standard error （平均）标准误差.;n.[化]元素硒(selenium)的符号，硒.;
con	vt.记诵,精读adv.反对地,反面n.反对票,反对论,[医]肺病;console,控制台
trying	adj.令人难于忍受的.难堪的.令人厌烦的.;v.试图( try的现在分词).试验，尝试.审讯.;
whereas	 conj.然而,反之,鉴于,尽管,但是
precise	adj.清晰的.精确的.正规的.精密.;
operation	n.运转,操作,实施,作用,业务,工作,手术,军事行动
side	n.边,旁边,面,侧面,胁,一方,(一个)方面,摆架子adj.旁边的,侧面的,副的,枝节的vi.站在同一边
mean	adj.低劣的,卑鄙的,普通的,吝啬的,简陋的,平均的,惭愧的,不舒服的vt.意谓,想要,预定vi.用意,有意义n.平均数,中间,中庸
guess	vt.推测.猜测，臆测.猜中.假定，认为.;vi.猜，猜测.猜对.;n.猜测.推断.;
bet	n.赌,打赌v.赌,赌钱
lookup	v.查找.查表.;
said	adj.[律]上述的.少说为妙.（做）某事有/没有很多优点（或好处）：某事物有/没有多少可说的.说到底.;v.说，讲( say的过去式和过去分词 ).表明.念.说明.;
case	n.事,病例,案例,情形,场合,讼案,容器,(语法)格
outcome	n.结果.成果.出路.;
affect	vt.影响.假装.感动.（疾病）侵袭.;n.感情，情感，心情.[精神病学]（表露或觉察到的）情绪反应.;
type	n.类型,典型,模范,[印刷]活字,铅字v.打字,测定(血等)类型
consulting	adj.商议的，顾问资格的，咨询的.;v.商议，商量( consult的现在分词 ).请教.翻阅.求教于.;
further	adj.更远的，较远的.更进一步的，深一层的.更多的.;adv.进一步地.更远地.而且.;vt.促进，推动.增进.;
terminology	n.专门名词.术语，术语学.用辞.;
found	vt.创办，成立，建立.;v.发现（ find的过去式）.找到.到达.发觉.;
second	n.秒.瞬间.次货.第二份食物.;adj.第二的.次要的.居第二位的.另外的.;adv.第二.其次.以第二位.;vt.支持.临时调派.附议.赞成提案.;
action	n.动作,作用,战斗,行动,举动,行为,(戏剧或书中)的情节,(某一地区、领域或团体中)最能产生效果、最有趣、最有刺激性的活动vt.对...起诉
summarize	v.概述,总结,摘要而言
yell	vt.& vi.叫喊，大声叫.叫喊着说.;n.叫喊，大声叫.（拉拉队鼓动运动员的）呼喊声.;
raise	n.上升,高地,提出vt.升起,唤起,提高,使出现,解除,饲养,筹集,使复活
assign	vt.分配,指派v.赋值 [计] 将驱动器符重定向至第二个驱动器符
eventually	adv.终于，最后.竟.总归.终究.;
lection	n.[宗]经文(礼拜时选读的)
col	n.关口,峡路,关隘  [军]上校 Col(Colonel)
current	adj.当前的,通用的,流通的,现在的,草写的,最近的n.涌流,趋势,电流,水流,气流
assignment	n.分给，分配.任务，工作，（课外）作业.<美>任命.指定，委派.;
declare	vt.宣布.声明，声称.申报.[法]供述.;vi.声明，发表宣言.宣称.;
otherwise	adv.否则.另外.别的方式.;adj.别的，另外的.不同的.;conj.否则，不然.;
move	vt.& vi.移动，搬动.;vi.搬家.行动.进展.（机器等）开动.;vt.提议.使感动.摇动.变化.;n.改变.迁移.;
declaration	n.宣言，布告，公告，声明.（纳税品在海关的）申报.[法]（原告的）申诉，（证人的）陈述，口供.[牌]摊牌，叫牌.;
ignore	vt.不理睬,忽视,[律](因证据不足而)驳回诉讼
particular	adj.特别的.详细的.独有的.挑剔的.;n.特色，特点.（可分类，列举的）项目.详细情节，细情，细目.某一事项.;
exist	vi.存在.生存.生活.继续存在.;
already	adv.早已，已经.先前.;
proceed	vi.进行.前进.（沿特定路线）行进.（尤指打断后）继续说.;n.收入，获利.;
accurate	adj.精确的，准确的.正确无误的.;
quite	adv.相当，很.非常.确实如此.;
stick	vt.& vi.粘贴.张贴.插入.刺入.;vt.容忍.产生作用.（尤指迅速或随手）放置.阻延或推迟.;n.棍棒，棍枝.枝条.操纵杆.球棍.;
label	n.标签,签条,商标,标志vt.贴标签于,指...为,分类,标注 [计] 加上或修改磁盘的标签
allocate	vt.分派,分配
pseudocode	伪代码.;
summed	v.总计 vbl.总计
produce	vt.& vi.生产.产生.制作.创作.;vt.制造.出示.引起.[经济学]生利.;n.产品.产量.产额.结果.;
assumption	n.假定,设想,担任,承当,假装,作态,圣母升天
reasonable	adj.合理的，公道的.明白道理的.适当的.有理性的.;
somewhat	adv.稍微.有点.达到某种程度.;n.少量.某些数量.某种程度.;
treat	n.宴请,款待,请客vt.视为,对待,论述,治疗,款待vi.交涉,谈判,协商,款待,作东
break	vt.（使）破.打破（纪录）.（常指好天气）突变.开始.;vi.（嗓音）突变.突破.破晓.（价格）突然下跌.;n.破裂.中间休息.间断.短假.;
during	 prep.在...的期间,在...的时候
forth	adv.往前,向外
begin	v.开始,首先
currently	adv.当前，目前.通常，一般，现在.容易，流畅.普遍地.;
accessible	adj.易接近的.可理解的.易相处的.易感的.;
strict	adj.精确的.绝对的.严格的，严谨的.[植]笔直的.;
enforce	vt.强迫服从.实施，执行.加强.;
identifiers	标识符.;
declared	adj.公告的，公然的.;v.宣布( declare的过去式和过去分词 ).断言.申报（收益）.板球（在击球员还未全部出局时）宣布结束赛局.;
maintain	vt.保持.保养.坚持.固执己见.;
collect	vt.收集.收藏.接走.聚积.;vi.募捐.募集.;adj.由受话人付费的.;
section	n.部分,断片,部件,节,项,区,地域,截面
previous	adj.在前的,早先的adv.在...以前 返回上一级菜单
dirty	adj.恶劣的.肮脏的.卑劣的.下流的.;vt.弄脏，污染.使名声受玷污.;vi.变脏，污染.;
handle	n.（织物、毛皮等的）手感.手柄.举动.柄状物.;vi.操作，操控.容易搬运.;vt.用双手触摸、举起或握住.用手操作，操纵.处理或负责，管理.〈美〉买卖，经营.;
finish	n.完成,结束,磨光,末道漆,完美vt.完成,结束,用完,毁掉,使完美vi.结束,终结,停止,终止
responsible	adj.尽责的.承担责任.负有责任的.懂道理的.;
listen	vi.倾听.留心听.听信.（让对方注意）听着.;n.听，倾听.;
interact	v.相互作用.互相影响.互动.;
meet	vt.& vi.相遇.相识.开会.接触（某物）.;vt.满足.支付.迎接.经历（常指不愉快的事）.;n.运动会，体育比赛.猎狐运动（尤其英式英语）.;adj.适当的.合适的.恰当的.;
cast	vt.铸造.投掷.投射.脱落，脱皮.;n.铸型.演员表.轻微的斜视.投，掷骰.;vi.掷，投.计算，加.;
conversation	n.交谈，会话.交往，交际.会谈.（人与计算机的）人机对话.;
cess	n.税,税率,<爱>运气(=luck)
approach	vt.& vi.接近，走近，靠近.;vt.接近.着手处理.使移近.试图贿赂（或影响，疏通）.;n.方法.途径.接近.;vi.靠近.;
ready	adj.有准备的,准备完毕的,甘心的,情愿的,现成的,迅速的
pile	n.堆,大堆,高大建筑,<美口>大量钱财,<美>[核]反应堆,[电]电池组vi.堆起,堆积,积累,挤vt.堆于,累积,堆叠,打桩于,用桩支撑
snippet	n.小片,片断,摘录,<口>不足道的人,不知天高地厚的年轻人
sake	n.为了...之好处,出于对...的兴趣,缘故,理由,日本米酒
simplicity	n.简单，朴素.质朴，天真.卑贱.无知.;
discussion	n.讨论，谈论.详述，论述.;
hot	adj.热的.辣的.激动的.热门的.;vt.使兴奋，使激动.;adv.热的.紧迫的.;vi.变热.;
lazy	adj.懒惰的.没精打采的.慢吞吞的.;
trick	n.戏法，把戏.计谋，诀窍.骗局.恶作剧.;vt.哄骗，欺骗.打扮.;adj.弄虚作假的.有诀窍的.欺诈的.;
kind	n.〈古〉方式，方法.本质，天性.同类.某类.;adj.仁慈的，体贴的.友善的，好心的.温和.宽宏大量的.;
fast	adj.快的.走得快.感光快的.紧的.;adv.（比准确的时间或宣布的时间）快.迅速地.紧紧地.彻底地.;vi.禁食，（尤指）斋戒.;n.禁食期，斋戒期.断食，节食.;
ensure	vt.确保.担保获得[避免].使（某人）获得.使安全.;
microsecond	n.一百万分之一秒，微秒.;
mere	adj.仅仅，只不过.小的，轻微的.纯粹的.;n.小湖，池塘.〈英〉边境（线）.;
cases	n.案例.病例( case的名词复数 ).（需特别对待或注意的）人.事例.容器.;
occur	vi.发生.出现.闪现.;
ahead	adv.在（某人或某事物的）前面.向前.预先.在将来，为未来.;
build	v.建造,建筑n.构造,体格,体形
plenty	n.丰富，大量.充足，充裕，充分.;adv.相当地，充分地.（口）十分，充分.;adj.足够的，很多的，充裕的.很多的.;
luxury	n.奢侈，豪华.奢侈品，美食，美衣.乐趣，享受.不常有的乐趣（或享受、优势）.;adj.奢华的，豪华的.;
relevant	adj.有关的，中肯的.相关联的.确切的.有重大意义[作用]的，实质性的.;
high	adj.高的.高尚的，崇高的.高音调的.高级的，高等的.;adv.（程度等）高地.高价地.奢侈地.;n.高处，高位.[气象学]高气压.高压地带.高水平.;
shortly	adv.立刻，马上.简单地，扼要地.唐突地，简慢地.在即.;
think	vt.想.思索.以为.看待.;vi.思辩.考虑.构想.回忆.;adj.深思的.供思考的.;n.想.想法.;
stroke	n.一击.击球.划水动作.中风.;vt.划掉.轻抚.轻触.敲击.;vi.击球.作尾桨手，指挥划桨.;
painting	n.绘画.油画.上色，着色.颜料，油漆.;v.绘画（ paint的现在分词）.涂色于.;
collapse	vi.折叠.倒塌.崩溃.（尤指工作劳累后）坐下.;vt.使倒塌.使坍塌.使瓦解.;n.垮台.（身体的）衰弱.;
execution	n.实行,完成,执行,死刑,制作,(武器等的)破坏效果,杀伤力
performance	n.履行,执行,成绩,性能,表演,演奏
optimize	vt.使最优化，使尽可能有效.;
certainly	adv.无疑.当然.确定.肯定.;
able	adj.能够的.有能力的.有才干的.干练的.;
ted	vt.翻晒.;
gran	n.<非>奶奶，外祖母.;
manage	vt.使用.完成（困难的事）.经营.明智地使用（金钱、时间、信息等）.;vt.& vi.办理，设法对付.;vi.能解决（问题）.应付（困难局面等）.凑合着活下去.支撑.;
then	adv.那时.然后.那么.话说回来.;adj.当时的.那时的.;
memory	n.记忆,记忆力,回忆,存储(器),存储器 存储器,内存
reserve	n.储备.保护区.保留.替补队员.;vt.储备.保留.预约.;vi.预订.;adj.保留的.预备的.;
create	vt.创造,创作,引起,造成
actually	adv.实际上,事实上,竟然,居然,如今
instruction	n.授课.教诲.传授的或获得的知识，课程.[计算机科学]指令.;
machine	n.机器,机械,机动车辆,机构,设计,机械般工作的人,(政党的)领导集团,核心组织vt.机器制造,用车床加工
turn	n.转动,旋转,转变方向,轮流,时机,(一)回,倾向,癖性v.(使)转动,翻转,扭转,(使)变质,超过(年龄,数量等),车(成)
previously	adv.先前,以前
there	adv.在那里.那里.在那一点上.;pron.表示某物或某人的存在或某事的发生（常用作be, seem或appear的主语）.;int.（表示满足、烦恼）你瞧，好啦，得啦.;
say	vi.说， 讲.表明，宣称.假设.约莫.;vt.表明.念.说明.比方说.;n.发言权.说话.要说的话.发言权.;
mire	n.<尤文>泥潭.;vt.& vi.深陷.;
rather	adv.稍微，有点.相当，颇.宁愿.相反地.;int.当然啦，怎么不.;
vary	vi.变化.不同，偏离.[生]变异.;vt.使不同.使多样化.[音乐]变奏.;
executable	adj.实行的，执行的.可执行.;
generation	n.一代人.代（约30年），时代.生殖.产生.;
itself	pron.(it的反身形式).它自己，它本身.自身，本身.;
sion	 (=Zion)n.锡安,以色列人民
whose	pron.谁的.那个人的，那些人的.他的，他们的.;
node	n.节点.（计算机网络的）节点.[医]结节.植物的节.;
top	n.顶部,顶端,极点,顶蓬,陀螺,(常用复数)根菜植物的叶子,上部,盖子adj.最高的,顶上的,头等的vt.盖,戴,高耸,达到顶端,截去(植物)顶端,高过,超越vi.结束,完成,胜过
might	v.(past tense,past participle of may see may)n.力量,威力,权力,能,可能 aux.可以
abstract	adj.抽象的，理论上的.难解的.抽象派的.茫然的.;n.抽象概念.抽象派艺术作品.摘要.[化]萃取物.;vt.提取，分离.转移（注意等）.概括，摘录.<婉辞>剽窃.;
ast	abbr.astronomy 天文学.absolute space-time 绝对时空.air staff target 航空职员工作目标.advanced supersonic transport 高级超声波运输机.;
structure	n.结构.构造.建筑物.体系.;vt.构成，排列.安排.;
grammatical	adj.语法上的，符合语法规则的.;
represent	vt.表现，象征.代表，代理.扮演.作为示范.;vi.代表.提出异议.;
collectively	adv.全体地，共同地.;
tree	n.树,木料,树状物vt.赶上树n.[计] 显示驱动器的子目录结构vi.爬上树,逃上树
turning	n.旋转,转向,转弯处
array	n.队列，阵列.数组.一大批.衣服.;vt.排列.部署兵力.打扮，装饰.;
stream	n.河流，小河，川，溪.潮流，趋势，倾向.（事件等的）连续，（财富等的）滚滚而来.流出，流注，一连串.;vt.& vi.流，流动.;vi.飘扬.招展.鱼贯而行.一个接一个地移动.;vt.按能力分班（或分组）.按能力分班（或分组）.;
another	adj.又一个.再一个.另一的.其他一种.;pron.另一个，别个.再一个.;
distinct	adj.明显的，清楚的.卓越的，不寻常的.有区别的.确切的.;
fig	n.[植]无花果,无花果树,无价值的东西,少许,一些,服装vt.打扮,使马跑快
parse	vt.从语法上描述或分析（词句等）.;
invoke	v.调用
were	be的过去时复数和第二人称单数形式.有时代替 was,用于条件从句、动词 wish 之后等.;
stateless	adj.无国家的，无国籍的.;
center	n.中心.（球队的） 中锋.中心区.中枢.;adj.中央的，位于正中的.（在）中心的.;vt.集中.使聚集在一点.定中心.居中.;vi.居中，有中心，被置于中心.;
academic	adj.学院的，大学的，学会的，（学术，文艺）协会的.学究的，学理上的，空谈的，非实用的.〈美〉文科的，文学的.柏拉图学派的.;n.学者.大学教师，大学生，学会会员.纸上空论，空论.[A-]柏拉图哲学信奉者.;
between	 prep.在...之间,连接...,由...协力合作
difference	n.差异,差别,分歧,争论,[数]差额,差分adj.[数]微分的,[机]差动的
whether	pron.其中的哪一个.;n.可能的选择.;
persist	v.坚持.固执.存留.继续存在.;
soon	adv.立刻，马上.一会儿，不久.快.宁愿.;
blacklist	n.（受怀疑、受冷遇等的）黑名单.;vt.把（某人）列入黑名单.;
put	vt.放,摆,安置,表达,迫使,移动,提出,赋予vi.出发,航行,发芽,击n.掷,投击,笨蛋,怪人 vbl.put的过去式和过去分词adj.固定不动的
edition	n.版次，版本.（报纸、杂志的）一份.（广播、电视节目的）一期.（书、报、杂志等的）一版印刷总数.;
sale	n.出售,卖出,贱卖,廉价出售,销路,销售额
publish	v.出版,刊印vt.公布,发表
america	n.美洲.美国.[电影]亚美利加.;
printed	adj.印刷的,已印好的
mixing	n.混合，混频.;v.混合( mix的现在分词 ).（使）结交.相容.平安相处.;
fairly	adv.公正地,正当的,公平对待某人,公平地,相当地,还算,清楚地
giving	n.礼物，给予物.;v.给予，赠送( give的现在分词 ).（与名词连用描述某一动作，意义与该名词相应的动词相同）.供给.交给.;
assuming	conj.如果.;adj.傲慢的，自负的.僭越的.;v.取得（权力）( assume的现在分词).假设(assume的ing形式).假定.呈现.;
former	adj.以前的，从前的.在前的.前任的.;n.模型，样板.构成者，创造者.起形成作用的人.[无线]线圈架.;
calls	n.调用.;v.叫( call的第三人称单数 ).通电话.认为.估计.;
safer	adj.safe的比较级.;
technically	adv.技术上.学术上.专业上.严格说来.;
adding	n.加，增加.;v.加( add的现在分词 ).加入.增加.添加.;
fixed	adj.固定的,确定的,准备好的,固执的,不易发挥的,<美口>(在经济上)处境...的
shadowed	[计][WIN]附有阴影.;
covered	adj.大量的.有遮盖物的，（尤指）有顶的.;v.覆盖( cover的过去式和过去分词).掩护.包括.;
added	adj.更多的.附加的.额外的.;v.加.加入.增加.添加.;
bother	vt.烦扰,打扰vi.烦恼,操心n.麻烦,烦扰v.打扰
processing	n.（数据）处理.整理.配置.工艺（生产方法）设计.;v.加工( process的现在分词 ).处理.审阅.审核.;
performing	adj.表演的，履行的.;v.执行( perform的现在分词 ).履行.表演.扮演.;
assumed	adj.假装的.假冒的.假定的.被承担的.;v.取得（权力）( assume的过去式和过去分词 ).假设.假定.呈现.;
differently	adv.不同地，相异地.;
identifier	n.检验人，标识符.鉴别器.编号.识别符.;
simply	adv.简单地，朴素地.（引出概括或解释）不过，仅仅.简直.<非正>实在.;
broken	adj.破碎的，打碎的.（腿，臂等）已骨折的.（线条）虚线的，断续的.被打断的.;v.打破，折断(break的过去分词).打破（纪录）.损坏.;
var	n.[电]乏,无功伏安(无功功率单位)
instance	n.实例,建议,要求,情况,场合vt.举...为例,获得例证
token	n.代币.象征.记号.;adj.作为对某事的保证的.象征性的.作为标志的.;vt.预兆：预示或象征，预兆.;
meaningful	adj.意味深长的.有意义的.有意图的.隽.;
character	n.(事物的)特性,性质,特征(的总和),(人的)品质,字符,性格,特征,人物vt.写,刻,印,使具有特征
string	n.绳子，带子.线丝，植物纤维.串.[计算机科学]字符串.;vt.上弦，调弦.使排成一行或一系列.绑，系或用线挂起.延伸或扩展.;
breaking	n.破坏，阻断.;v.打破，折断，弄坏( break的现在分词 ).（使）破.打破（纪录）.（常指好天气）突变.;
roughly	adv.粗略地.大体上.大致上.粗暴地.;
execute	vt.执行,实行,完成,处死,制成,[律]经签名盖章等手续使(证书)生效
before	adv.在前,以前 prep.在...之前 conj.在...之前,与其...宁可
three	num.三.三个.第三（章，页等）.;n.三岁.三个人[东西].三，三个.;adj.三的.三个的.;
typically	adv.典型地.代表性地.通常.;
undergo	vt.经历，经验.遭受，承受.;
source	n.来源,水源,消息来源,原始资料,发起者 源,源极
process	n.过程.工序.做事方法.工艺流程.;vt.加工.处理.审阅.审核.;vi.列队行进.;adj.经过特殊加工（或处理）的.;
traditional	adj.传统的.口传的.惯例的.因袭的.;
albeit	conj.虽然.即使.;
step	n.步，脚步.步骤，手段.步调.级别.;vt.& vi.举步，行走.踩，踏上.跨入.轻快地走.;vi.踏，踩.走.;vt.跳舞.迈步.使成阶梯状.;
same	adj.同一的,相同的,无变化的,上述的,所谓 pron.同样的事物adv.同样地
nevertheless	adv.然而.尽管如此.不过.仍然.;conj.然而.尽管如此.;
system	n.系统,体系,制度,体制,秩序,规律,方法
distributed	adj.分布式的
among	 prep.在...之中,...之一
portable	adj.手提的.轻便的.;n.手提式打字机.;
compilation	n.编辑.汇编.;
result	n.结果,成效,计算结果vi.起因,由于,以...为结果,导致
traditionally	adv.传统上，传说上.;
advance	n.前进,提升,预付款v.前进,提前,预付adj.前面的,预先的 预付(款项)
compile	vt.汇编.编辑.编制.编译.;
interpret	vt.解释.理解.诠释，体现.口译.;vi.作解释.作口译.;
category	n.类型，部门，种类，类别，类目.[逻，哲]范畴.体重等级.;
despite	prep.不管.尽管（自己）不愿意.不在乎.虽有.;n.侮辱.憎恨.怨恨.轻蔑的拒绝或不承认.;
various	adj.各种各样的.多方面的.许多的.各个的，个别的.;
interaction	n.一起活动.合作.互相影响.互动.;
level	n.水平，水准.水平线，水平面.水平仪.[物]电平.;adj.水平的.同高度的.平均的.平稳的.;vt.使同等.对准.弄平.;vi.拉平.（用枪等）瞄准（与 at 连用）.变得平坦.将（话、批评等）对准目标.;vi.瞄准.拉平.变得平坦.;
depend	vi.依靠.依赖.信赖.决定于.;
surprising	adj.使人惊讶的，出人意料的，惊人的.惊人的，意外的.奇怪的，不可思议的.;v.使惊奇，使诧异( surprise的现在分词).意外发现[撞见]，出其不意获得.;
evident	adj.明显的，明白的.昭著.彰.;
self	n.自己.本人.本性.私利.;adj.同一的.纯净的.单一的.;vt.使自花授精.使近亲繁殖.;vi.自花授精.;
call	v.呼唤，喊叫.召唤，叫来，召集.下令，命令.打电话给.;n.喊叫，大声喊.电话联络.必要，理由.要求.;
finding	n.发现物.研究结果.调查（或研究）的结果.<律>（陪审团的）裁决.;v.发现( find的现在分词).;
location	n.位置,场所,特定区域,<美>[电影]外景拍摄场地
story	n.故事,小说,传说,事迹,经历,假话,谎话
rule	n.规则，规定.统治，支配.章程.;vt.& vi.控制，支配.判定.裁定，裁决.价格稳定.;vt.统治.规定.管理.裁决.;vi.统治.管辖.裁定.;
set	v.放,置,移动到,使(人或事物处于某种状态),提出,树立,规定,调整;n.一套,一副,一批,接受机,装置,趋势,布景;adj.固定的,规定的,坚决的,固执的,事先做好的;Secure Electronics Transations Protocol,安全电子商务协议
define	vt.定义,详细说明
speak	v.说话,谈话,说明事实,表示意见,发言,演讲,操(某种语言)
live	vi.生存.居住.生活，过活.在生活中得到享受.;vt.经历.度过.;adj.活着的.生动的，有精神的.精力充沛的.现场直播的.;adv.在（表演）现场，实况地.;
beget	vt.(书面语) 招致,产生,引起
inclusion	n.包含.内含物.;
interesting	adj.令人感兴趣的，有趣的.引起兴趣的.有趣的.令人关注的.;
terribly	adv.很.非常.极.非常糟糕地.;
limited	adj.有限的.（君主权力）受宪法限制的.〈美〉乘客名额有限制的.（智力，能力等）有限的.;n.高级快车.直达的火车或汽车.;
extremely	adv.极端地.非常，很.去.绝.;
task	n.工作，任务.作业.苦差事.;vt.交给某人（任务）.使过于劳累.;
perform	vt.& vi.执行.履行.表演.扮演.;vt.工作.做.进行.完成.;vi.运行，表现.（驯兽）玩把戏.;
give	vt.& vi.给予.赠送.作出.;vt.供给.产生.举办.（为购买某物或做某事而）支付.;vi.（物体）塌下.让步.;n.伸展性，弹性.;
pull	vt.& vi.拉.扯.拉过来.划（船）.;vt.赢得.吸引异性.取消.（耍手腕）得逞.;n.拖.爬.影响力.;
modify	vi.被修饰.修改.;vt.改变.减轻，减缓.[语]修饰，（用变音符号）改变.;
retrieve	vt.取回.恢复.[计]检索.重新得到.;vi.找回猎物.;n.恢复，挽回.取回.[计]检索.;
store	n.商店.贮存物.仓库.大量.;v.贮存.（在计算机里）存储.;
ability	n.能力，资格.能耐，才能.;
paradigm	n.范例，样式，模范.词形变化表.;
fundamental	adj.基础的，基本的，根本的，重要的，原始的，主要的，十分重大的.[物]基频的，基谐波的.[乐]基音的.;n.原理，原则，基本，根本，基础.[乐]基音.[物]基频，基谐波.;
chapter	n.(书籍)章
xii	num.罗马数字 12.;
check	n.阻止,制止,控制,阻止物,支票,检讫的记号,饭馆的帐单vt.检查,制止,核对,寄存,托运vi.证明无误,核对无误,逐项相符,[象棋]将军
watch	vt.注视，注意.看守，监视.守候（机会等）.密切注意.;n.表.值夜，值班.看守，监视.值班人员.;vi.观看.注视.守候.看守.;
twitter	vi.（人因兴奋）嘁嘁喳喳地讲.（鸟）叽叽喳喳地叫.格格地笑.（激动得）抖颤.;vt.（鸟等）吱吱叫.唧唧喳喳地讲述.颤动.抖动.;n.（鸟）叽叽喳喳的叫声.格格的笑声.一个网站名称.;vt.& vi.在Twitter网站上写信息.;
follow	vt.& vi.跟随，接着.;vt.继承.（按时间、顺序等）接着.从事.采用.;vi.理解.发生兴趣.由此产生.跟着人（或物）去（或来）.;n.追随，跟随.[台球]推球，跟球打法（使竿击的球在击中目的球后继续滚动的打法）.;
website	WWW(环球网)的站点
news	n.新闻.消息.（可当作新闻内容的）人.物.;
conference	n.会议.讨论.（正式）讨论会.[工会、工党用语]（每年的）大会.;vi.举行或参加（系列）会议.;
courses	n.课程，路线.前进( course的名词复数 ).进程.课程.方针.;
send	vt.送.使作出（某种反应）.派遣.使进入（某状态）.;vt.& vi.用无线电波发送，发出信息.;vi.派遣，发出，派人.;adj.[仅用作定语]用于发送的.;
technical	adj.技术（性）的，工艺的，学术（上）的，专门（技术）的，艺术的.[法]根据法律的，法律上的.[商]人造的，用工业方法制造的，由市场内部因素（如投机等）引起的.〈美俚〉外表的，表面上的，浅薄的.;
comment	n.评论.注释.意见.说明.;vt.& vi.评论，谈论.;vt.表达意见.解释，注释.;vi.作注释.作注解.作解释.作评语.;
additional	adj.额外的，附加的.另外的，追加的.补充.外加.;
any	adj.任何的.一点，一些.普通的.任何，随便哪一个.;pron.任何.无论哪个.若干.;adv.稍微，少许.什么，一些，一点.;
list	n.目录,名单,列表,序列,数据清单,明细表,条纹,[总称]各种上市证券vt.列出,列于表上,记入名单内,装布条vi.列于表上
page	n.页,记录,事件,专栏vt.标明...的页数,翻...的书页vi.翻书页
xi	n.希腊字母的第14个字母.;
fax	n.vt.传真 /n.传真/调制解调器
local	adj.地方的.当地的，本地的.局部的.褊狭的.;n.慢车.本地居民（律师、教士、医生）.住处附近的当地酒店.本地新闻.;
international	adj.国际的.两国（或以上）国家的.超越国界的.国际关系的.;n.国际组织.国际体育比赛.外国居留者.国际股票.;
canada	n.加拿大.;
concerning	 prep.关于
comments	n.批评，意见，评论.评论( comment的名词复数 ).注释.谈话.说明.;
visit	n.拜访,访问,游览,参观,(作客)逗留,视察,调查vt.拜访,访问,参观,视察,降临vi.访问,参观,闲谈
please	int.请.;vt.& vi.使高兴.使满意.讨人喜欢.讨好.;
ens	n.有，实体.;
doz	dioctyl azelate [化]壬二酸二辛酯
bartlett	n.西洋梨的一种.;
jones	n.<美><俚>瘾，毒瘾，固着型依恋.;
hill	n.小山,丘陵,斜坡,山岗
rider	n.骑手，骑马的人，善于骑马的人，骑师.（精密天平上的）游（动砝）码.附文，附加条附加条款款.扶手.;
manning	n.（工厂等的）人员配备，（列车、轮船或飞机等的）全体乘务员（或工作人员）.;
apres	prep.在...以后
ft	abbr.foot[feet] 英尺.金融时报(Financial Times).飞行试验(Flight Test).;
adobe	n.风干土坯.风干砖坯.（制风干砖用的）灰质粘土.泥砖砌成的房屋.;adj.用土坯建造的.;
ibm	abbr.individual-based modeling 个体化模组.;
morgan	n.摩根马(美国佛蒙特州轻型马,与美国快马相似)
john	n.抽水马桶.厕所.;
cisco	n.[动物]加拿大白鲑(一种青鱼) Cisco系统公司是企业网络产品的全球领先供应商
focal	adj.焦点的，有焦点的.集中在点上的.病灶的，病灶性的.;
sam	 [军] Surface to Air Missile,地对空导弹 萨姆防空导弹
press	vt.压，按.逼迫.紧抱.;vi.压.逼迫.重压.;n.强迫征兵.新闻报道，出版物.压榨.印刷机（厂）.;
microsoft	n.美国微软公司.;
hall	n.过道，走廊.大厅，前厅.娱乐中心，会所.;
prentice	n.学徒，徒弟.;adj.徒弟的，无经验的.;vt.使做学徒.;
pub	n.酒馆，酒店.客栈.;
fully	adv.充分地.完全地.足足.彻底地.;
manuscript	n.手稿.原稿.底稿.手写本.;adj.手写的，手抄的.;
publication	n.出版物,出版,发行,公布,发表
thousands	n.数千.一千( thousand的名词复数 ).数千.许许多多.千位数.;
access	n.入口，出口.接近，进入.增长.爆发.;vt.接近，进入.使用，接近，获取.;
scriber	n.划线器，描绘标记的用具.;
sub	n.潜水艇.代用品，代替者，替补队员.地铁.审校员.;vi.做替身，做替补队员.做替身，审校（文稿）.;
individual	adj.个人的.独特的.个别的.;n.个人.个体.;
agency	n.代理处,行销处,代理,中介
government	n.政府.政体.治理的形式.管辖，治理.;
organization	n.组织.机构.团体.;adj.有组织的.;
gram	n.绿豆.鹰嘴豆.绿豆种子.克.;
pro	adv.正面地  (英国)档案局 PRO(Public Record Office)
pricy	adj.价格高的，昂贵的.;
mix	vt.& vi.混合.（使）结交.相容.平安相处.;n.混录.食物混合配料.乐曲组合.;vt.调配，配制.;vi.混合录音，混录，混音.;
range	n.山脉,行列,范围,射程vt.排列,归类于,使并列,放牧vi.平行,延伸,漫游
training	n.训练.培养.（枪炮，摄影机等的）瞄准.整枝法.;v.训练，培养( train的现在分词).教育.瞄准.整枝.;
solving	v.解决( solve的现在分词 ).解答.解释.揭示.;
resource	n.[pl.] 资源,财力,办法,智谋
primary	adj.首要的，主要的.最早的，原始的.[地质学]原生的.基本的.;n.第一位.最好者.要素.候选人提拔会.;
creative	adj.创造性的，有创造力的.有创意的，创新的，创造的.;n.（非正式）创意人士.;
leading	adj.重要的，主要的.前列的.首位的.;n.行距.铅框.;v.领导（lead的ing形式）.;
form	n.形状，形式.外形.方式.表格.;vt.形成.构成.组织.塑造.;vi.形成，产生.排队，整队.;
video	n.电视,录象,视频
both	adj.两者,双方的 pron.双方,两者
expert	n.专家，能手.权威.行家，高手.熟练者.;adj.专家的.（技术）熟练的.老手.需要专门知识（或技术）的.;vt.以专家身份研究（或检查），像专家那样研究（或检查）.由专家审读（书籍等）.;vi.做专家工作，担任专家，成为高手（或能手）.;
deliver	vt.递送,陈述,释放,发表(一篇演说等),交付,引渡,瞄准,给予(打击)
digital	adj.数字的.数据的.手指的.指状的.;n.手指.（钢琴等的）琴键.数字.;
demand	vt.要求，请求.需要.[法]召唤.询问，盘问.;n.需求.需要.要求，请求.销路.;vi.需要.请求.查问.;
safari	n.游猎，陆路旅行（尤指在东非或中非）.类似游猎的假日旅行.旅行队.;
free	adj.自由的.免费的.免税的.空闲的.;adv.免费地.自由地，无拘束地.一帆风顺地.;vt.免除.释放.使自由.解救.;
above	adj.上面的,上述的,上文的;adv.在上面;prep.在...上方,过于,超出
given	adj.赠予的,沉溺的,特定的,假设的 vbl.give的过去分词
fair	adj.公平的.合理的.晴朗的.美丽的.;adv.公平地.直接地.清楚地.正大光明地.;n.集市，庙会.商品交易会，展览会.美人，美丽的事物.;vt.（卡通制作）顺利接合.（动作）衔接协调.（飞机）装配平整.使（飞机接合部）平滑.;vi.转晴.;
outside	n.外面,外表,外界adj.外面的,外表的,外界的adv.在外面,外表,出界 prep.在...外
fall	n.秋天,落下,瀑布,降低,落差,采伐量,堕落,下降vi.倒下,落下,来临,失守,变成,垮台,下跌,阵亡vt.<美><英方>击倒,砍倒(树木)adj.秋天的
feel	vt.感觉.认为.触摸.试探.;vt.& vi.感觉，觉得.认为，以为.触摸.;n.感觉.触摸.感受.触觉.;vi.觉得.摸索.;
son	n.儿子,女婿,(长者对年轻男子的称呼)孩子,<基督教>圣子,耶稣基督
simp	n.笨人.;
include	vt.包括.包含.计入.包住.;
attribution	n.归属.归因.属性.归属物.;
appreciate	vt.感激.欣赏.领会.鉴别.;vi.（使）增值，涨价.;
product	n.产品.结果.乘积.作品.;
amount	n.量，数量.总额.本利之和.全部效果，全部含义.;vi.（在意义、价值、效果、程度等方面）等于.等同，接近.合计，总共.发展成为.;
incorporate	adj.合并的,结社的,一体化的vt.合并,使组成公司,具体表现vi.合并,混合,组成公司vt.[律]结社,使成为法人组织
quire	n.一刀（纸数量），（装订时的）一折.;
quote	vt.& vi.引述，引用.;vt.报价.引述.;vi.引用.;n.引用.报价.引号.;
cd	Compact Disc,光盘;Cd,元素镉(cadmium);Collision Detect,碰撞侦测;Carrier Detect,载波检测
distributing	vbl.分配,分发,分布
selling	n.贩卖，出售.;v.卖，售，销( sell的现在分词 ).经销.推销.出卖.;
require	vt.要求.需要.想要.命令.;vi.要求，规定.;
chunk	n.厚厚的一块.（某物）相当大的数量或部分.强壮、结实的马.;
writing	n.文字.写作.文章.笔迹.;v.写（ write的现在分词）.写信.;
portion	n.一部分,一分
significant	adj.重要的.有意义的.有重大意义的.值得注意的.;n.有意义的事物.象征，标志.;
reproducing	v.复制( reproduce的现在分词 ).重现.再版.生殖.;
permission	n.允许.批准，正式认可，认可.;
documentation	n.证明某事属实的证据.记录.参考资料.文献的编集，文件分类.;
download	v.将（程序，资料等）从大计算机系统输入小计算机系统，下载.;
etc	adv.等等及其他.诸如此类.;abbr.[拉丁语]et cetera（常读作 and so forth）.;
material	n.材料，原料.素材.布，织物.适当人选.;adj.物质的.肉体的.重要的，决定性的.辩证的，推论的.;
supplemental	adj.补足的，追加的.;
caution	n.小心.警告.〈英〉担保.〈口〉须警惕的事或人.;vt.警告.提醒.;
warning	n.警告.征候，预兆.前车之鉴.;adj.警告的.告诫的.引以为戒的.;v.警告( warn的现在分词).提醒.告诫.预先通知.;
suggestion	n.建议，意见，暗示.联想，启发.微量.;
tip	n.顶,尖端,梢,倾斜,轻击,末端,小费,秘密消息vt.在...顶端装附加物,使倾斜,使翻倒,暗示,轻击,给,泄露,给小费vi.倾斜,翻倒,倾覆,踮脚走,给小费n.提示,技巧
signify	vt.表示,意味vi.要紧,有重要性v.颇为重要,表示
element	n.[化]元素.要素.原理.[电]电阻丝.;
context	n.上下文.背景.环境.语境.;
determined	adj.坚定的.毅然的.确定的.;v.（使）下决心，（使）做出决定( determine的过去式和过去分词).决定.确定.使决定.;
literally	adv.逐字地.照字面地.确实地，真正地.[口语]差不多，简直（用于加强语意）.;
typed	v.打字 vbl.打字
text	n.文本，原文.课文，教科书.主题.版本.;v.发短信.;
command	n.命令，指挥.司令部，指挥部.[计算机]指令.控制力.;vt.指挥，控制，命令.命令.应得，值得.;vi.给出命令.命令，指令.;adj.指挥的，根据命令（或要求）而作的.;
bold	adj.明显的，醒目的.勇敢的，无畏的.莽撞的.陡峭的.;n.粗体字.黑体字.;
statement	n.声明.（思想、观点、文章主题等的）表现.（文字）陈述.结算单.;vi.（英国）对儿童进行特殊教育评估认定.;vt.申请（小孩）有特殊教育需要.;
types	n.类型v.打字
data	n.资料，材料.datum的复数.[计算机]数据，资料.从科学实验中提取的价值.;
database	n.数据库.资料库.信息库.;
variable	adj.变化的，可变的.[数]变量的.[生]变异的.;n.可变因素，变量.易变的东西.;
elements	n.原理，基础.要素（旧时认为土、空气、火和水是构成一切物质的四大要素）( element的名词复数 ).（化学）元素.基础.成分.;
refer	vt.提交,谈及,归诸于,指点把...提交,使求助于vi.提到,涉及,查阅,咨询
paragraph	n.(文章)段,节,段落
within	n.内部,里头adv.在内部,在内心里 prep.在...之内,不越出adj.里面的,内部的
listing	n.列表.名单.（刊印在报纸上的如电影、戏剧等.（名单中的）一个位置.;v.列表(list的现在分词）.;
width	n.宽度,宽广,广博,有一定宽度的东西(如一快布料等) /n.宽/高比
constant	adj.不断的，持续的.永恒的，始终如一的.坚定.忠实的.;n.[数]常数，常量.不变的事物.永恒值.;
extension	n.延长,扩充,范围n.扩展名adj.[逻]外延的,客观现实的
file	n.文件,档案,文件夹,卷宗,锉刀vt.把...归档,提出(申请等),锉,琢磨vi.列队行进,用锉刀锉
filename	n.文件名.;
url	abbr.ultraviolet light 紫外线.user requirements language 用户需求语言.;
term	n.学期,期限,期间,条款,条件,术语
indicate	vt.指出,显示,象征,预示,需要,简要地说明
italic	adj.（印刷字体）斜体的.（书写）整齐尖细的.(I-)古意大利的.;n.斜体字.;
typographical	adj.印刷上的，排字上的.;
following	n.下列各项,部下,党羽adj.下列的,其次的 prep.在...之后
convention	n.会议.全体与会者.国际公约.惯例，习俗，规矩.;
pre	Petroleum Refining Engineer炼油工程师
run	n.跑,赛跑,奔跑,运转,趋向vi.跑,奔,逃跑,竞选,跑步,蔓延,进行,行驶vt.使跑,参赛,追究,使流,管理,运行,开动adj.熔化的,融化的,浇铸的 vbl.run的过去式和过去分词
version	n.版本.译文，译本.说法.倒转术.;
environment	n.环境，外界.周围，围绕.工作平台.（运行）环境.;
engine	n.发动机,机车,火车头
modern	adj.现代的.近代的.新式的.当代风格的.;n.现代人，现代主义者.时髦人士.[印]现代字体，指印刷中所用的一种字体.;
examples	n.例子.榜样( example的名词复数 ).例子.样本.样板.;
inspiring	adj.鼓舞人心的.激励的.启发灵感的.;vt.鼓舞(inspire的现在分词).激励.启迪.;
aim	n.目标,目的,瞄准v.对...瞄准,打算
lack	vt.缺乏，缺少.需要的东西.;n.缺乏，不足，没有.缺少的东西.;
confusion	n.混乱.混淆.困惑.;
sufficiently	adv.足够地，充分地.十分，相当.;
completely	adv.完全地.完整地.完全，彻底，全部，一干二净.很，非常，充分，十分，万分.;
partially	adv.部分地.<古>偏袒地，偏爱地.一部分.;
awesome	adj.令人敬畏的.使人畏惧的.可怕的.极好的.;
await	vt.等候.等待.期待.;
shadow	n.阴影.影子.鬼，幽灵.隐蔽处.;vt.投阴影于.使朦胧.跟踪，尾随.预示.;vi.渐变.阴沉.;adj.影子内阁的.阴影的.非正式的.;
burn	vt.& vi.& link-v.（使）燃烧.;vt.& vi.使用某物为燃料.烧毁.烧坏.烧伤.;n.烧伤，烧痕.;
handed	adj.有手的.;
need	vt.需要.必须.;aux.必须.不得不.;n.需要.需要的东西.责任.贫穷.;vi.（表示应该或不得不做）有必要.;
practical	adj.实践的，实际的.可实现的，实用的.注重实际的.可用的.;
confidence	n.信心.信任.秘密.;adj.骗得信任的.欺诈的.;
firm	adj.坚固的，坚牢的.坚定的，坚决的.严格的.确定的.;vt.& vi.使坚固.使坚实.;n.商号，商行.公司.企业.工作集体.;adv.坚定地，稳固地.;vt.使坚定，使牢固.;vi.变坚实，变稳固.;
reading	n.阅读.宣读.读物.读数.;v.读( read的现在分词).看懂.理解.显示，标明.;
exhaustively	adv.用尽一切地.;
dive	vi.潜水.跳水.急剧下降.（头朝下）跳入水中.;n.潜水.跳水.俯冲，（潜艇）下潜.（气温，股价等的）暴跌，跳水.;vt.& vi.突然下降，暴跌.;
understood	v.懂，理解( understand的过去式和过去分词 ).了解.默认.听说.;
core	n.果核,中心,核心
specific	adj.明确的.特种的.具体的.[免疫学]特效的.;n.特效药.特性.细节.显著的性质，特性.;
standing	n.起立，站立.身份，地位.持续时间.;adj.长期有效的.直立的.固定的.;v.站立.坚持不变.;
beyond	 prep.在(到)...较远的一边,超过,那一边adv.在远处n.远处
acronym	n.只取首字母的缩写词
popular	adj.流行的，大众化的.民众的，大众的，公众的.通俗的，普通的，平易的.〈美俚〉自以为了不得的，骄傲的.;
viii	num.罗马数字 8.;
framework	n.构架.框架.（体系的）结构.机构，组织.;
technique	n.技术,技巧,方法,表演法,手法
embrace	vt.& vi.拥抱.;vt.包括.包含.接受.信奉.;n.拥抱，怀抱.;
traveled	adj.富有旅行经验的.旅客多的.旅客使用的.旅客常到的.;
bumpy	adj.崎岖的.颠簸的.气流不稳的.;
journey	n.旅行,旅程v.旅行
gently	adv.温柔地.轻轻地.有礼貌地.文雅地.;
stopping	v.停止( stop的现在分词 ).中断.逗留.（使）停止工作.;
nor	conj.也不.也不是.和 neither 或 not 连用.去甲.;
rough	adj.粗糙的，崎岖不平的.粗鲁的.狂暴的，汹涌的.未经加工的.;vt.粗暴地对待.使粗糙.草拟.;n.粗糙的部分.艰难，苦难.（高尔夫球场的）深草区.;adv.粗暴地.;vi.举止粗野.;
road	n.路,道路,公路,大道
retreat	vi.撤退，后退.撤销，作罢.（眼睛等）凹进.[航]向后倾斜.;n.撤回.静居处.引退期间.静思，静修.;
advice	n.劝告，忠告.（商业）通知.建议.（政治，外交上的）报导，报告.;
eschew	vt.避开，回避.;
furthermore	adv.此外.而且.与此同时.再者.;
behave	vi.表现.举止端正.自然反应.;vt.使守规矩.;
force	n.力量,武力,精力,魄力,势力,暴力,[复]军队,影响力vt.强制,强加,(用武力)夺取,促使,推动,施加压力
tendency	n.倾向，趋势.（话或作品等的）旨趣，意向.性情.癖好.;
head	n.头,头脑,领袖,(队伍,名单等)最前的部分,人,顶点vt.作为...的首领,朝向,前进,用头顶vi.成头状物,出发adj.头的,主要的
tough	adj.坚强的，坚韧的，不屈不挠的.艰苦的，困难的，难办的.牢固的，强壮的.粗暴的.;n.粗暴的人.暴徒，恶棍.;vt.<口>忍耐，忍受（常与out连用）.;adv.强硬地，顽强地.以强硬的态度.;
contrary	adj.相反的.违反的，反对的.对立的.顽固的，任性的.;n.对立或相反的事物.对立方.[逻]反对命题.;adv.相反地，矛盾地.;
offer	vt.提供，给予.提出，提议.出价，开价.表示愿意.;vi.提议.企图，想要.供奉.;n.提议.出价，开价.试图.求婚.;
incomplete	adj.不完全的.未完成的.不完备的.片.;
safe	adj.安全的.保险的，肯定的.无损的.提供保护的.;n.保险箱，保险柜.冷藏箱.〈俚〉避孕套.;
consider	vt.考虑,照顾,认为
reader	n.读者，朗读者.读本.讲读者，讲师.审稿人.;
dear	adj.亲爱的.敬爱的.昂贵的.严厉的.;n.亲爱的人.宠物.;int.哎.;adv.高价地.疼爱地.贵.;
implore	vt.恳求或乞求（某人）.;vi.恳求，乞求.;
good	adj.好的.优秀的.有益的.漂亮的，健全的.;n.好处，利益.善良.善行.好人.;adv.同well.;
dub	vt.[电影]配音,轻点,授予称号,打击n.鼓声,笨蛋
subset	n.[数]子集
richness	n.丰富,浓烈,富裕,富饶,华美
shell	n.（贝、卵、坚果等的）壳.外壳.炮弹.（人的）表面性格.;vt.去壳，脱落.炮击.;vi.剥皮.炮轰.;
hollow	adj.空的.空洞的.虚伪的.空腹的.;n.洞，坑.山谷.;vt.& vi.挖空（某物），变空.挖出（孔、洞）.;adv.完全，彻底.;
relegate	v.转移,归入,提交
tome	n.册.卷.大而重的书.一本巨著.;
some	adj.一些.某个.大约.相当多的.;pron.一些.若干.其中的一部分.（数量不确切时用）有些人.;adv.非常.相当.<美>稍微.;
add	vt.增加,添加,计算...总和,补充说,又说;vi.加,加起来,增添,做加法
response	n.反应.回答，答复.[宗]回应经文，应唱圣歌.;
frustration	n.挫折.失败.挫败.失意.;
surprise	n.惊奇,诧异,惊人之事,奇袭vt.使惊奇,奇袭adj.令人惊讶的
encounter	vt.不期而遇.遭遇.对抗.;n.相遇，碰见.遭遇战.对决，冲突.;vi.碰见，尤指不期而遇.;
point	n.点.要点.得分.标点.;vt.（意思上）指向.削尖.加标点于.指路.;vi.表明.指向.;
mission	n.使命,任务,使团,代表团
attain	vt.& vi.达到，获得.遂愿.经过努力到达某事物.;vt.达到，实现.获得.到达.;vi.达到.获得.到达.;
presently	adv.目前.不久.马上.;
challenge	n.挑战vt.向...挑战
heel	n.脚后跟，踵.（鞋、袜等的后跟）.（四足动物的）后脚.踵状物.;vt.& vi.（使）倾斜.;vt.给（鞋等）修理后跟.;
achilles	n.<希神>阿喀琉斯（希腊勇士，出生后其母握其脚踵倒提着在冥河水中浸过，因此除未浸过的脚踵之外，浑身刀枪不入）； 阿基里斯（小行星558号）.;
paradox	n.反论，悖论.似非而是的论点.自相矛盾的人或事.[物]佯谬.;
lies	n.谎言.谎言( lie的名词复数 ).位置.假象.;v.躺卧，说谎.位于( lie的第三人称单数 ).说谎.展现.说谎.;
therein	adv.其中，在那里.在那点上，在那方面.;
seasoned	adj.经验丰富的,老练的
true	adj.真正的.真实的.忠实的.正确的.;adv.真正地.确实地.正确地.正当地.;n.真理，真实.正，准，精确.;vt.摆正.决定（某物）的位置以使其平衡、平稳或水平.;
elude	v.躲避
mechanics	n.(用作单数)机械学、力学,(用作复数)技巧,结构
collection	n.收集，采集.征收.收藏品.募捐.;
nuance	n.细微差别.细微的表情.;
complex	adj.复杂的.难懂的.复合的.;n.建筑群.相关联的一组事物.情结.不正常的忧虑.;
peal	n.（声音大而持续或重复的）洪亮的响声.隆隆声.洪亮的钟声.钟乐.;vt.& vi.（使）（钟等）鸣响，（雷等）发出隆隆声.;
simultaneously	adv.同时地.一壁.齐.一齐.;
hood	n.头巾,兜帽,车蓬,引擎罩v.用头巾包裹,给...加罩,覆盖
script	n.脚本，手迹.书写体铅字.剧本、广播稿或者电影剧本.;vt.为电影（或戏剧等）写剧本.编造.;
encourage	vt.鼓励，鼓舞.支持.促进.鼓动.;
callback	n.回收，回叫信号，复查.;
passing	adj.经过的，路过的.短暂的.及格的.正在发生的.;adv.非常地.无以伦比地.;n.经过，通过.经过之处，通过的手段.死亡.;v.走过( pass的现在分词).;
simplistic	adj.过分单纯化的.过分简单化的.把复杂问题搞得过于简单的.;
seemingly	adv.看来似乎.表面上看来.貌似.;
tend	vt.照料，照顾.护理.照管，管理.;vi.倾向（于），趋向（于）.伺侯，招待.关心.注意.;
rooted	adj.生根的，有根的.固定的，根深蒂固的.;v.生根.使（某事物）深深扎根.;
sophisticated	adj.复杂的.精致的.富有经验的.深奥微妙的.;v.使变得世故.使迷惑.篡改(sophisticate的过去分词形式).;
surface	n.表面.外观，外表.地面。水面.;vi.浮出水面.在表面工作.显露.;vt.使浮出水面.使成平面.;adj.表面的，外观的.外表上的，平地上的.肤浅的.;
scratch	n.乱写,刮擦声,抓痕,擦伤vt.乱涂,勾抹掉,擦,刮,搔,抓,挖出vi.发刮擦声,搔,抓adj.打草稿用的,凑合的
barely	adv.仅仅，勉强，好容易才.几乎不，几乎没有.赤裸裸地，无遮蔽地.公然地，露骨地，公开地.;
program	n.节目,程序,纲要,计划vt.规划,拟...计划,安排...入节目vi.安排节目,编程序 (电脑)程序,(电视)节目
scale	n.刻度,衡量,比例,数值范围,比例尺,天平,等级vt.依比例决定,攀登,测量vi.剥落,生水垢,重,攀登,衡量
write	vt.书写,著述,写,写满,写信给vi.写,写字,写信,写作,作曲
depth	n.深度.深处，深海.深奥，奥妙.进深.;
pretty	adj.漂亮的.机灵的，聪明的.;adv.相当，颇.;n.漂亮的人（或东西）.;
than	 conj.比 prep.与...相比较
occurrence	n.发生,出现,事件,发生的事情
mastery	n.精通，熟练.统治，控制.优势.;
solid	n.固体,立体adj.固体的,实心的,坚固的,结实的,立体的,可靠的,一致的,纯粹的
eccentricity	n.古怪.反常，怪癖.[物]偏心距.[数]离心率.;
running	n.跑步.运转.流出.;adj.跑着的.流动的.连续的.操作中的，运转着的.;v.跑.运转(run的ing形式).;
perhaps	adv.或许.（表示不确定）也许.（用于粗略的估计）或许.（表示勉强同意或其实不赞成）也许.;n.假定.猜想.未定之事.;
exposure	n.暴露,揭露,暴光,揭发,揭露,位向,方向,陈列
comfortable	adj.舒适的.安逸的，处于轻松的.充裕的.;
inviting	adj.吸引人的，诱人的.引人注目的.;v.邀请(invite的现在分词).;
programming	n.规划，设计.编程.;v.训练( programme的现在分词 ).培养.预调.;
developer	n.开发者.<摄>显影剂，显像剂.;
audience	n.观众，听众，读者.读者.接见.拥护者，爱好者.;
broad	adj.宽的,阔的,广泛的,明朗的,露骨的,显著的,主要的adv.宽阔地n.宽阔部分
exceedingly	adv.非常，极其，特别，十分.极大地.过分地.极度地，极端.;
functional	adj.功能的.[数]函数的.有多种用途的.机能性.;
lisp	n.咬舌，口齿不清（把s音发成th音）.;vt.& vi.（说话）咬舌（把s音发成th音）.;
scheme	vt.& vi.策划，图谋.;n.计划.体系.阴谋.;vt.设计，计划.谋划，图谋.;vi.密谋，制定计划.;
obvious	adj.明显的.显著的.平淡无奇的.自明.;
less	adj.较少的（little的比较级）.较小的.较次的，较劣的.较不重要的.;adv.较少地，较小地.;prep.减去.少掉.不足.;n.较少，较小.;
subtle	adj.狡猾的,敏感的,微妙的,精细的,稀薄的
procedural	adj.程序的.有关程序的.;
proud	adj.自豪的，得意的.光荣的，高尚的.傲慢的.有自尊心的.;
including	prep.包括.包含.;v.包括( include的现在分词).包含.列入.包住.;
several	adj.几个的.专有的.各自的.分别的.;pron.几个，数个.一些.;
idiom	n.习语，成语.方言，土语.（语言）风格.惯用语法.;
syntax	n.[语]语法,有秩序的排列,句子构造,句法
concept	n.观念，概念.观点.思想，设想，想法.总的印象.;
borrow	vt.& vi.借入.借钱，借用.[数]由上位借.抄袭.;n.借，借用.担保物，抵押.[英史]什一税.;
carnival	n.狂欢节.嘉年华.节日，联欢.;
important	adj.重要的.权威的.有势力的.有地位的.;
different	adj.不同的.各式各样的.个别的.不平常.;
vastly	adv.极大地.广大地.深远地.;
guage	n.线规，进度指示.;
marketing	n.销售，经销，行销，商品销售业务.市场学.商品自生产者转移到消费者手中的一系列有关机能.〈集合词〉市场购买的货品，适合市场上销售的货品.;vt.出售.为出售提供.;vi.卖.买.;
politics	n.政治.政治事务.政治观点.权术.;
accident	n.意外事件.事故.机遇，偶然.附属品.;
merely	adv.仅仅，只不过.只是.纯粹.全然.;
mature	adj.成熟的,到期的,充分考虑的,(票据等)到期的vt.使成熟vi.成熟,到期
next	n.adj.下次的,其次的,与...连接,下一个adv.下一次,其次
status	n.地位.情形，状态.身份.;
kid	n.<口>小孩.小山羊，小山羊皮制品.;vt.& vi.欺骗，戏弄，取笑.;adj.较年幼的.小山羊皮制的.;
dumb	adj.哑的，无说话能力的.不说话的，无声的.沉默的，无言的.口齿不清的，（在政府中）无代言人的，政治上无发言权的.;
evoke	vt.产生，引起.唤起.;
phi	n.希腊文的第21个字母.;
design	vt.& vi.设计.绘制.;vt.设计.计划.企图.决意（做）.;n.设计.图案.结构.计划.;vi.设计略图.（为工艺品、装潢项目等）设计.当设计师.构思.;
heritage	n.遗产.继承物.传统.文化遗产.;
partly	adv.在一定程度上.部分地.不完全地.半.;
owing	adj.(～ to) 由于,该付的,未付的,应归功于
criticism	n.批评，批判.鉴定，审定，考证，校勘.苛求，[哲]批判主义.评论，评论文章.;
deal	vt.[牌戏]分.分配.经营.施予.;n.（一笔）交易.许多.待遇.发牌.;vi.论述.（有效地或成功地）处理.惩处.交易.;adj.冷杉木制的，松木制的.;
perpetually	adv.永恒地.终身地.不断地.;
platform	n.(车站)月台,讲台,讲坛 平台
software	n.软件.软体.软设备.;
widely	adv.广泛地.普遍地.到处.大量地.;
importance	n.重要性.重要地位，显著.骄傲，自大.;
doubt	n.怀疑，疑虑.未确定.;vt.怀疑，疑惑.;vi.不确定，不能肯定或怀疑.;
magnitude	n.巨大，广大.重大，重要.量级.（地震）级数.;
order	n.次序,顺序,正常(工作)状态,秩序,会议规则,命令,定购,定单vt.命令,定购,定制
grown	adj.长大的,成年的,长满某物的 vbl.grow的过去分词
capability	n.才能，能力.容量.性能.生产率.;
decade	n.十年，十年间.十个一组.十年期.;
nearly	adv.几乎，差不多.险乎.;
prompt	adj.敏捷的.迅速的.立刻的.准时的.;v.促使.导致.鼓励.提示.;n.激励.提示符.提词.提示.;adv.准时地.;
pop	vi.（意外地、突然地）出现.突然出现.发出爆裂声.（突然地）行动.;vt.（突然地）伸出.（突然地）提出问题.（把准备好的东西）突然拿出来.敲击.;n.流行音乐.汽水.（尤用作称呼）爸.（迅速打上的）记号.;adj.流行音乐的.通俗风格的.通俗的.现代的.;adv.爆炸；砰地.;abbr.邮局协议(post office protocol).;
annoying	adj.讨厌的.恼人的.;v.骚扰(annoy的ing形式).;
trail	n.踪迹,痕迹,形迹vt.跟踪,追踪,拉,拖,拖拉,(指植物)蔓生,蔓延,(指人)没精打采地走
mouse	n.老鼠.鼠标.羞怯[胆小]的人.[非正式用语] 眼部青肿.;vi.捕鼠.窥探，偷偷地寻找.;
flickering	adj.闪烁的.摇曳的.忽隐忽现的.一闪一闪的.;v.（通常指灯光）闪烁，摇曳( flicker的现在分词 ).;
consume	vt.消耗,消费,消灭,大吃大喝,吸引vi.消灭,毁灭
experience	n.经验，体验.经历，阅历.;vt.亲身参与，亲身经历.感受.发现.;
interactive	adj.互相作用的，相互影响的.[计]交互式的.互动的.;n.交互式视频设备.;
drive	n.驾车,驱动器,快车道,推进力,驱使,动力,干劲,击球vt.开车,驱赶,推动、发动(机器等),驾驶(马车,汽车等)vi.开车,猛击,飞跑n.[计]驱动器
technology	n.科技（总称）.工业技术.工艺学.[总称]术语.;
identify	vt.识别,鉴别,把...和...看成一样v.确定
quirk	n.奇事，巧合.怪癖.突然的弯曲.;
cursing	n.诅咒，逐出教会.;
though	conj.虽然，尽管.即使.纵然.;adv.可是，但是.不过.然而.话虽这样说.;prep.但.;
curse	vt.& vi.诅咒.咒骂.使苦恼，使困苦.把（某人）逐出教门.;n.诅咒.咒语.祸害，祸因.咒逐，逐出教门.;
notice	n.注意.布告.警告.预告.;vt.& vi.注意.;vt.通知.留心.关照.注意到.;vi.引起注意.;
net	n.网,网络,网状物,净利,实价adj.净余的,纯粹的vt.用网捕,净赚,得到vi.编网 [域] Nerwork operations and service centers,网络服务商
www	abbr.world wide wait 环球等待.;
hudson	abbr.hudson seal (imitation seal made of dyed muskrat fur) 汉德森河海豹皮（由染色的麝鼠毛皮制成的仿海豹皮）.;
shane	n.谢恩(m.).;
using	v.使用（ use的现在分词 ）.利用.耗费.吸（毒）.;n.使用.利用.用途.使用权.;
instead	adv.代替，顶替.反而.反倒.;
general	n.普通,将军,概要adj.一般的,普通的,综合的,概括的,全面的,大体的 n.常规
creep	vi.爬行，匍匐.缓慢地行进.;n.爬行，蠕动.虫爬着似的感觉，毛骨悚然.卑鄙小人，谄媚者.;
language	n.语言,语言文学,术语,语言表达能力,(运用语言的)方式、能力、风格,[自](机器)代码 /n.语言/国家
bit	n.一点，一块.少量，少许.一会儿，一转眼.[计] 比特（二进位制信息单位）.;adj.很小的，微不足道的.;adv.[口语]相当，有点儿，或多或少，多少[a bit to的省略].;vt.给（马）上嚼子.上衔铁.抑制.制约.;v.咬，叮( bite的过去式).刺痛.咬饵.有咬（或叮）的习性.;
tiny	adj.极小的，微小的.;n.小孩子.[医]癣.;
thinking	n.思想
critically	adv.批判性地.苛求地.危急地.严重地.;
hope	n.希望，期望.希望的东西.被寄予希望的人或事物、情况.抱有希望的理由.;vt.& vi.希望，期望.;vt.[俚语]相信，认为.;vi.希望，盼望，期待.;
intro	n.<口>(社交场合的)介绍,爵士乐(或流行音乐)的引子
let	vt.假设,出租,允许,排放,让...进入(或通过),妨碍vi.出租,(工程等)被承包n.出租屋,障碍
feature	n.面貌的一部分(眼,口,鼻等)特征,容貌,特色,特写vt.是...的特色,特写,放映vi.起重要作用
new	adj.新的，崭新的.新鲜的，新到的.现代的.初次（听到）的.;adv.新近，最近.;
learning	n.学问，学术，知识.;v.学习(learn的现在分词).;
yet	adv.但是.还.已经.又，再.;conj.然而，但是.;
browser	n.浏览程序.浏览器（用于在互联网上查阅信息）.浏览图书报刊者.逛商店的人.;
across	adv.横过,交叉地,在对面 prep.越过,交叉,在...的那边,在...对面那边
implementation	n.成就.贯彻.implement的变形.安装启用.;
settling	n.沉淀物.;v.安排( settle的现在分词 ).安放.安家.（使）安定.;
finally	adv.最后，终于.总算.末后.结果.;
perfect	n.完成式adj.完美的,全然的,理想的,正确的,熟练的,精通的完成式的vt.使完美,修改,使熟练
coming	adj.即将到来的.下一个的.将要遭到报应.自食恶果.;n.（尤指新事物的）到来.到达.;v.来( come的现在分词).到达.达到（认识、理解或相信的程度）.出生.;
working	adj.（涉及）工作的.（人）有工作的.（时间）用于工作上的.（想法等）可作为基础的.;v.（使）工作( work的现在分词).（使）运作.运转.（使）产生效果.;n.工作.活动.制作.操纵.;
realize	vt.认识到,了解,实现,实行
teach	vt.教.教导，训练.教授.;vi.教书.;
hopefully	adv.有希望地.有前途地.抱有希望地.;
me	pron.（人称代词I的宾格）我.;n.自我.自我的一部分.极端自私的人.[音乐]固定唱法时的E音.;
people	n.人,人们,民族,人类,公民vt.使住(满)人
target	n.目标,对象,靶子
brilliant	adj.明亮的.<非正式>美好的.闪耀的.才华横溢的.;n.宝石.钻石.;
wish	n.愿望,心愿,请求,所愿望的事物,祝愿v.希望,想要,但愿,祝贺
six	n.六.六个.六岁.六点.;num.六.六个.;
lists	n.竞技场.一览表( list的名词复数 ).目录.名单.清单.;
mailing	n.<美>邮寄.投递.邮件.<苏格兰>农场租金.;v.邮寄( mail的现在分词 ).;
specs	n.眼镜.投机，说明，规格( spec的名词复数 ).规范.;
read	vt.& vi.阅读，朗读.显示.研究.看得懂.;vt.显示.阅读.读懂，理解.;n.阅读.读物.读书.里德（人名）.;adj.被朗读的.博识的.博览的.有学问的.;
lot	n.签,抽签,一堆,许多,命运,一块地,份额vt.划分vi.抽签,抓阄
understand	vt.& vi.懂，理解.;vt.了解.默认.听说.领会.;
stand	n.台，看台.立场.停止.抵抗.;vi.站立，起立.竖直放置.保持看法.停滞.;vt.使站立.忍受.抵御.承担责任.;vt.& vi.站立，（使）直立，站着.;
done	adj.已完成的.煮熟的.合乎礼仪的.合乎规矩的.;int.（表示接受建议）.;v.做( do的过去分词).干.;
series	n.系列，连续.串联.（广播或电视上题材或角色相同的）系列节目.级数.;
excited	adj.兴奋的，激动的.活跃的.激发的.受刺激的.;v.使兴奋（ excite的过去式和过去分词）.;
exactly	adv.精确地.确切地.完全地，全然.恰恰.;
tool	n.工具,用具,爪牙,走狗,手段vt.用工具加工,使用设备vi.使用工具
rarely	adv.很少地.罕有地.极精彩地.珍奇地，绝佳地.;
bug	n.小虫,臭虫,缺陷,错误;v.装置窃昕器,打扰
fix	vt.使固定,装置,修理,准备,安装,凝视,整理,牢记vi.固定,注视,决定,选定,确定n.困境,方位,贿赂
problem	n.问题.疑难问题.习题.引起麻烦的人.;adj.成问题的.难处理的.关于社会问题的.;
solve	vt.解决.解答.解释.清偿（债务）.;
best	adj.最好的( good和well的最高级).最愉快的.最幸福的.最合适的.;adv.最好地.最出色地.最高标准地.;n.佼佼者.（个人的）最高水平.最重要的优越性.最好的东西，最合乎要求的事物.;vt.[口]打败，胜过.;
longing	n.渴望，热望.;adj.渴望的.极想得到的.;v.渴望(long的现在分词).;
myself	 pron.我自己,我亲自,我本人
find	vt.找到,发现,感到,查明,得到,认为,见到...的存在vi.裁决n.发现 [计] 在文件中查找指定的字符串
loving	adj.爱的，表示爱意的，亲爱的.;adv.亲爱地.;n.爱.慈爱.;v.爱，热爱(love的现在分词).喜爱.喜好.喜欢.;
spite	n.(in ～ of)不顾,不管,敌意v.困扰
de	abbr.demand 需要.double end 双径.data entry 数据输入.decision element 决定要素.;
however	adv.无论如何,可是,仍然,究竟 conj.不管用何种方法,然而,可是
close	v.关,关闭,结束,停止,使靠近,靠拢,会合,包围n.结束adj.近的,紧密的,精密的,齐根的,封闭的,亲密的,闷气的adv.接近,紧密地
course	n.过程,经过,进程,方针,路线,跑道,课程,一道菜v.追猎,急行,运行,流动 学业
took	v.拿( take的过去式 ).接受.学习.取得.;
love	vt.& vi.爱，热爱.爱戴.喜欢.赞美，称赞.;vt.喜爱.喜好.喜欢.爱慕.;n.爱情，爱意.疼爱.热爱.爱人，所爱之物.;
spend	vt.& vi.用钱，花钱.;vt.花费.消耗.花（时间）.度过.;n.（为某目的或某段时间内的）花销，花费，开销.;
professional	n.自由职业者,专业人员,职业运动员,职业艺人adj.专业的,职业的
considered	adj.经过仔细考虑的.经过深思熟虑的.受尊敬的.经过深思熟虑的看法.;v.考虑( consider的过去式和过去分词).想.注意.看重.;
unfortunately	adv.不幸地，遗憾地.可惜.不巧.;
learn	vt.& vi.学习，学会.习得.得知.记住.;vt.记住.学习.得知.认识到.;vi.学习.获知.;
favorite	n.特别喜欢的人（或物）.喜欢的事物.最有希望获胜者（尤指马）.收藏夹.;adj.喜爱的，宠爱的，中意的.;[美国英语] = favourite.;
fact	n.事实，实情.实际.真相，证据.犯罪行为.;
answer	vt.& vi.答复. 解答. 答辩.适应.;n.回答.答案.反应.足以媲美的人.;
addicted	adj.沉溺于某种嗜好中的
become	vi.变为，成为.变得.变成.;vt.适合，适宜.相称，相当.变成.发生.;
transistor	n.晶体管.晶体管收音机，半导体收音机.;
which	pron.哪一个.哪一些.哪个.那，指前面提到的事物.;adj.哪一个.哪一些.;
rod	n.杆，拉杆.惩罚，体罚.（责打人用的）棍棒.手枪.;
ferrite	n.（正）铁酸盐，铁素体.铁氧体.;
wrapping	n.包装材料.包装纸.;v.包，裹住(wrap的现在分词).;adj.包装用的.;
antenna	n antenae <动>触角 (antenna)n.天线
remove	vt.开除.去除.脱掉，拿下.迁移.;vi.迁移，移居.离开.;n.距离，差距.移动.;
happen	vi.发生,碰巧,偶然v.发生,恰巧,偶然发现
look	vt.& vi.看，瞧.;vi.注意.面向.寻找.看起来好像.;n.看.（尤指吸引人的）相貌.眼神.样子.;int.（插话或唤起注意）喂，听我说.;
mode	n.方式.状况.时尚，风尚.调式.;
research	n.研究,调查vi.研究,调查
went	v.进行( go的过去式 ).去.进展.;
immediately	adv.立即,马上,直接地
purpose	n.意志.目的.作用.（进行中的）行动.;vt.有意.打算.企图（做）.决意（做）.;
wrapped	adj.有包装的,预先包装的
wire	n.金属丝,电线,电报,电信,铁丝网vt.用金属丝卷起,拍电报vi.打电报adj.金属丝制的
copper	n.铜.铜币.紫铜色.警察.;adj.铜制的.;vt.镀铜.;
tube	n.管,管子,[英] 地铁,<美> 电子管,显象管
long	adj.长的.长时间的.冗长的，过长的.长音的.;adv.长久地.始终.遥远地.;n.长时间，长时期.[语]长音节.（服装的）长尺寸.长裤.;vi.渴望，极想.;
weird	adj.怪诞的，超自然的.奇怪的，奇异的.<古>命运的，宿命的.不可思议的.;n.命运，宿命.厄运.<古>命运女神.;
had	v.有（ have的过去式和过去分词 ）.（亲属关系中）接受.拿.买到.;
radio	n.无线电.收音机.无线电广播台.无线电收发报机.;vt.& vi.用无线电发送讯息.作无线电广播.用X射线拍照.;
board	n.木板,(供特殊用途的)木板,甲板,膳食费用,会议桌,部vt.用板盖上,包饭,提供膳食,上(船、飞机等)
circuit	n.电路，线路.巡回.唤醒，环形道.〔电〕电流.;vt.巡回，周游.;
looking	adj.有...样子的,有...相貌的
remember	vt.回忆起,铭记,纪念vi.记得
worked	adj.处理过的，作装饰用的.;v.（使）工作( work的过去式和过去分词 ).（使）运作.运转.（使）产生效果.;
ask	vt.& vi.问，询问.需要.要求，请求.邀请.;vt.邀请.请求允许.要价.询问.;vi.请，邀请.询问.要求.;
instantly	adv.立即地,即刻地
broke	vt.打破(break的过去式和过去分词).折断.;adj.破产的.缺乏资金的.;
whenever	adv.究竟什么时候.不论何时.;conj.无论什么时候.随时.无论何时.每当.;
device	n.装置,设计,图案,策略,发明物,设备 [计]安装设备驱动程序
these	adj.这些的.;pron.这些.;
hand	n.手.协助，帮助.（工具等的）把，柄.掌管.;vt.传递，交给.搀扶.支持.;
else	adv.其他.否则.另外.;adj.别的.其他的.;
anything	pron.任何东西.（用于否定句、疑问句中以及 if 或 whether 和 prevent、ban、avoid 等动词后，代替 something）任何东西.重要东西.重要事物.;
stereo	adj.立体声的.有立体感的.;n.立体声.立体声系统.铅板.立体系统或立体像片.;
fi	 [域] Finland ,芬兰
mobile	adj.可移动的.行动自如的.易变的.流动性的.;n.风铃.手机.;
putt	n.（高尔夫球）轻击.;vt.& vi.把（球）轻轻打进洞里.轻轻一击.;
apart	adv.相隔，相距.分散地，分开地.成部分，成碎片.分辨.;adj.分离的，隔离的.;
taking	adj.吸引人的.迷人的.唾手可得.随手可拿.;adv.引人注目地，迷人地.;n.引人注目，迷人.;v.拿( take的现在分词 ).接受.学习.取得.;
child	n.孩子,儿女,子孙,(头脑、空想等的)产物,弟子,追随者
acknowledgment	n.承认，承认书，感谢.;
dynamic	adj.动态的.动力的，动力学的.充满活力的，精力充沛的.不断变化的，充满变数的.;n.动态.动力，推动变化的力量.动力学.活力.;
module	n.模块.组件.（宇宙飞船上各个独立的）舱.测量流水等的单位.;
loop	n.环,线(绳)圈,弯曲部分,回路,回线,(铁路)让车道,(飞机)翻圈飞行vt.使成环,以圈结,以环连结vi.打环,翻筋斗n.循环
gritty	adj.多沙的，含砂的.勇敢的，坚毅的，坚定的.;
nitty	adj.多虱卵的，<口>愚蠢的，笨的.;
enlightenment	n.启迪，启发.教化，开导.启蒙运动.;
strike	n.罢工,打击,殴打vt.打,撞击,冲击,罢工,打动,划燃,到达,侵袭vi.打,打击,罢工,抓,敲,搏动,打动,穿透
hoist	vt.升起，提起.;vi.被举起或抬高.;n.起重机，升降机.升起.<俚>推，托，举.;
scopes	n.领域，范围.（处理、研究事务的）范围( scope的名词复数 ).能力.（活动或能力的）余地.视野.;
plain	n.平原.平地.[纺织业]平针.朴实无华的东西.;adj.平的.素的.清晰的.相貌平平的.;adv.清楚地，明白地.平易地.[用以加强语气]显然.完全地.;vi.发牢骚.诉苦.;
hiding	n.隐匿,隐藏之事,痛打,隐匿之所
block	n.块.街区.<英>大楼，大厦.障碍物，阻碍.;vt.阻止.阻塞.限制.;
versus	 prep.对(指诉讼,比赛等中),与...相对
function	n.官能,功能,作用,职责,典礼,仪式,[数]函数vi.(器官等)活动,运行,行使职责
cheat	vt.欺骗，诈骗.误导，愚弄.躲避，逃脱.;vi.作弊，行骗.犯规.俚〉不忠.消磨，解（闷），消除（疲劳）.;n.欺骗（行为）.骗子.雀麦.〈美俚〉反光镜.;
lex	n.<拉>法,法律,法律体系,罗马公法,罗马私法
lexical	adj.词汇的.具词典性质的，词典的.;
nested	adj.嵌套的.;v.筑巢( nest的过去式和过去分词 ).;
understanding	vt.理解，懂得.熟知，通晓.获知，理解.谅解.;vi.理解，懂得.表示同情或谅解.据说.;n.认识，了解.谅解.知识.;adj.能谅解的.宽容的.通情达理的.;
theory	n.理论,学说,...论,原理,意见,推测
compiler	n.汇编者.编辑者.编纂者.（电脑的）编译程序.;
preface	n.序文,绪言,前言vi.作序,写前言vt.为...写序言,开始
foreword	n.前言，序（言）.;
content	n.内容.（书等的）目录.满足.容量.;adj.满足的，满意的.愿意的.心甘情愿的.;vt.使满足，使满意.;
herein	adv.此中，于此.焉.;
contained	v.控制( contain的过去式和过去分词 ).克制.牵制.包含.;
resulting	adj.作为结果的，因而发生的.;v.发生( result的现在分词 ).导致.随着发生.结果发生.;
damage	vt.& vi.损害，毁坏.;n.损害，损毁.赔偿金.;
omission	n.省略，删节.遗漏.疏忽.[法]不履行法律责任.;
error	n.错误，过失.[法]误审，违法.[数]误差.;
responsibility	n.责任.职责.责任感，责任心.负责任.;
assume	v.假定，认为.承担.装出.呈现.;
author	n.著作家.作者.创造者.发起人.;vt.创作出版.;
publisher	n.出版者，出版商，出版社.公布者，发表者.〈美〉办报者.;
preparation	n.准备，预备.准备工作.配制品.制剂.;
taken	v.拿( take的过去分词).接受.取得.;
precaution	n.预防，防备，警惕.预防措施.避孕措施.;vt.使提防.预先警告.;
initial	adj.最初的.开始的.首字母的.;n.首字母.[语音学]声母.特大的大写字母.;vt.用姓名的首字母签名.;
cap	n.帽子,军帽,(瓶)帽,(笔)帽;vt.戴帽子,盖在...顶上;carrierless amplitude and phase,相幅载波
aware	adj.意识到的.知道的.觉察到的.;
this	adj.这,这个,今,本 pron.这,这个
appear	vi.出现，显现.出庭，出场.演出.发表.;
distinguish	vi.区分，辨别，分清.辨别是非.;vt.区分，辨别，分清.辨别出，识别.引人注目，有别于.使杰出，使著名.;
sellers	n.卖者( seller的名词复数 ).卖方.销售者.销售商.;
manufacturer	n.制造商，制造厂.厂主.[经]厂商.;
designation	n.指示,指定,选派,名称
dress	n.女服,童装,服装,衣服v.(给...)穿衣
trade	n.贸易,商业,交易,生意,职业,行业,[气]信风,顾客vi.交易,买卖,经商,对换,购物vt.用...进行交换
related	adj.有关系的.叙述的.;vt.叙述(relate过去式和过去分词).;
javascript	n.[计算机]Java描述语言（一种脚本语言）.;
don	n.<西>君,先生(西班牙语冠于男子姓名前),阁下,(英国剑桥或牛津大学)指导教师vt.穿上
trademark	n.（注册）商标.（人的行为或衣着的）特征，标记.;
registered	adj.注册的.登记过的.已挂号的.（动物）附有血统证明的.;v.记录.登记.注册.显出.;
logo	n.（某公司或机构的）标识，标志，徽标.logotype 的缩略形式.[计算机] LOGO 教学语言.儿童教学语言.;
nutshell	n.坚果的外壳.简言之，一言以蔽之.;
details	n.详细资料.详述( detail的名词复数 ).（照片、绘画等的）细部.细目.各种细节.;
errata	n.正误表，勘误表.写错( erratum的名词复数 ).排错.错误.错字勘误表.;
catalog	n.目录,目录册v.编目录
release	vt.释放.放开.发布.发行.;n.释放，排放，解除.释放令.公映的新影片，发布的新闻[消息].;
history	n.历史，历史学.发展史.履历，经历.（某地的）沿革.;
revision	n.修订，修改.修订本.校对.复审，上诉.;
march	vi.（坚定地向某地）前进.行军，进军.游行示威.进展，进行.;vt.使前进.使行军.;n.行进，前进.行军.游行示威.进行曲.;
illustrator	n.插图画家,图解者,说明者
david	abbr.data above video 超视频数据.digital and video interactive device 数字和视频交互设备.digital audio/video interactive decoder 数字音频/视频交互式解码器.digital anthropometric video imaging device 数字人体测量视频成像设备.;
interior	n.内部.内地.内政.内心.;adj.内部的.内地的，国内的.内面的.;
karen	[女子名] 卡伦 Katherine,Kathleen,Kathryn等的昵称.[女子名] 卡伦 Catherine的丹麦语变体.[人名]可怜.;
designer	n.设计师.设计者.构思者.;adj.由专门设计师设计的.标有设计师名字的.时尚的.时髦的.;
cover	n.盖子,封面,藉口vt.覆盖,铺,掩饰,保护,掩护,包括,包含,适用vi.覆盖,涂,代替
proofreader	n.校对者.;
melanie	n.梅勒妮(f.)
production	n.生产，制作.产品.产量.夸张的行动或形象，小题大做.;
donald	n.唐纳德（男子名，涵义：世界领袖）.;
mac	n.橡胶雨衣n.[计] =Macintosh;[军] Millitary Airlift Command,军事空运司令部;Media Access Control,介质访问控制
brian	n.布赖恩（亦作Bryan）(m.).;[男子名] [英格兰人姓氏] 布赖恩 Bryan的变体.;
department	n.部门，部.系，学部.知识范围.车间.;
institutional	adj.由来已久的. 习以为常的. 公共机构的. 慈善机构的.;
corporate	adj.法人的，团体的，社团的.公司的，总体国家的.〈古〉团结的.共同的，全体的.;
contact	n.接触,联系vt.接触,联系
information	n.通知,报告,消息,情报,知识,见闻,资料,起诉 信息
title	n.头衔,名称,标题,冠军,资格,字幕,权利,扉页vt.赋予头衔,加标题于adj.标题的,用作书名的
promotional	adj.促销的.增进的.;
business	n.商业,买卖,交易,生意,事情,事物,营业,商行
educational	adj.教育（方面）的.为教育的.有教育意义的.提供咨询的.;
purchase	v.购买.采购.换得.依靠机械力移动.;n.购买.购买行为.购置物.紧握.;
sebastopol	塞瓦斯托波尔（克里米亚半岛西南岸港市）.;[地名] [哥伦比亚、美国] 塞瓦斯托波尔.[地名] [乌克兰] 塞瓦斯托波尔.;
north	n.北方.北部.（美国南北战争时与南方作战的）北部各州.北方发达国家（尤指欧洲和北美各国）.;adj.北方的.北部的.朝北的.（风，光线）来自北方的.;adv.在北方.自北地.向北方.;
highway	n.公路.公用通道.干线.途径，方法.;
gravenstein	n.格拉文施泰因苹果.;[人名] 格拉文斯坦.;
state	n.情形,状态,国家,政府,州adj.国家的,国有的,国营的,州的,正式的,典礼用的vt.声明,陈述,规定
reserved	adj.预订的.矜持的.储藏着的.;v.保留[储备]某物( reserve的过去式).;
inc	abbr.include 包括.income 收入.incoming 进入的.included 包含的.;
kyle	n.<苏>狭海峡
closure	n.（永久的）停业，关闭.结束.[电]闭合.[数]闭包.;vt.使结束，使终止.使停止辩论.;
scope	n.（处理、研究事务的）范围.眼界，见识.（活动或能力的）余地.广袤，地域.;v.审视，仔细研究.;
ell	n.旧时量布的长度.弯头.肘管.;
united	adj.联合的,团结的,一致的
copyright	n.版权,著作权
all	adj.全部的.一切的.各种的.极度的，尽量的.;pron.全部.一切.每个人，每件东西.全部情况.;adv.全部地.完全地.每个.非常.;n.全体.[常作A-]整体.[常与my, your, his, her等连用]（某人）所有的一切.;
solution	n.解答,解决办法,溶解,溶液 解决方案
